Rank,NOC,Gold,Silver,Bronze,Total,Year,HostCountry
1,USA,11,7,2,20,1896,Greece
2,GRE,10,18,19,47,1896,Greece
3,GER,6,5,2,13,1896,Greece
4,FRA,5,4,2,11,1896,Greece
5,GBR,2,3,2,7,1896,Greece
6,HUN,2,1,3,6,1896,Greece
7,AUT,2,1,2,5,1896,Greece
8,AUS,2,0,0,2,1896,Greece
9,DEN,1,2,3,6,1896,Greece
10,SUI,1,2,0,3,1896,Greece
11,Mixed team,1,0,1,2,1896,Greece
1,FRA,27,39,37,103,1900,France
2,USA,19,14,15,48,1900,France
3,GBR,15,7,9,31,1900,France
4,Mixed team,8,5,6,19,1900,France
5,BEL,6,7,4,17,1900,France
6,SUI,6,2,1,9,1900,France
7,GER,4,3,2,9,1900,France
8,ITA,3,2,0,5,1900,France
9,AUS,2,0,3,5,1900,France
10,DEN,1,3,2,6,1900,France
11,HUN,1,2,2,5,1900,France
12,CUB,1,1,0,2,1900,France
13,CAN,1,0,1,2,1900,France
14,ESP,1,0,0,1,1900,France
14,LUX,1,0,0,1,1900,France
16,AUT,0,3,3,6,1900,France
17,NOR,0,2,3,5,1900,France
17,NED,0,2,3,5,1900,France
19,IND,0,2,0,2,1900,France
20,BOH,0,1,1,2,1900,France
21,SWE,0,0,1,1,1900,France
1,USA,76,78,77,231,1904,United States
2,GER,4,5,6,15,1904,United States
3,CAN,4,1,1,6,1904,United States
4,CUB,3,0,0,3,1904,United States
5,HUN,2,1,1,4,1904,United States
5,Mixed team,2,1,1,4,1904,United States
7,NOR,2,0,0,2,1904,United States
8,AUT,1,1,1,3,1904,United States
9,GBR,1,1,0,2,1904,United States
10,SUI,1,0,2,3,1904,United States
11,GRE,1,0,1,2,1904,United States
12,AUS,0,3,1,4,1904,United States
13,FRA,0,1,0,1,1904,United States
1,GBR,56,51,39,146,1908,United Kingdom
2,USA,23,12,12,47,1908,United Kingdom
3,SWE,8,6,11,25,1908,United Kingdom
4,FRA,5,5,9,19,1908,United Kingdom
5,GER,3,5,5,13,1908,United Kingdom
6,HUN,3,4,2,9,1908,United Kingdom
7,CAN,3,3,10,16,1908,United Kingdom
8,NOR,2,3,3,8,1908,United Kingdom
9,ITA,2,2,0,4,1908,United Kingdom
10,BEL,1,5,2,8,1908,United Kingdom
11,AUS,1,2,2,5,1908,United Kingdom
12,RUS,1,2,0,3,1908,United Kingdom
13,FIN,1,1,3,5,1908,United Kingdom
14,RSA,1,1,0,2,1908,United Kingdom
15,GRE,0,3,1,4,1908,United Kingdom
16,DEN,0,2,3,5,1908,United Kingdom
17,BOH,0,0,2,2,1908,United Kingdom
17,NED,0,0,2,2,1908,United Kingdom
19,AUT,0,0,1,1,1908,United Kingdom
1,USA,26,19,19,64,1912,Sweden
2,SWE,23,25,17,65,1912,Sweden
3,GBR,10,15,16,41,1912,Sweden
4,FIN,9,8,9,26,1912,Sweden
5,FRA,7,4,3,14,1912,Sweden
6,GER,5,13,7,25,1912,Sweden
7,RSA,4,2,0,6,1912,Sweden
8,NOR,3,2,5,10,1912,Sweden
9,CAN,3,2,3,8,1912,Sweden
9,HUN,3,2,3,8,1912,Sweden
11,ITA,3,1,2,6,1912,Sweden
12,AUS,2,2,3,7,1912,Sweden
13,BEL,2,1,3,6,1912,Sweden
14,DEN,1,6,5,12,1912,Sweden
15,GRE,1,0,1,2,1912,Sweden
16,RUS,0,2,3,5,1912,Sweden
17,AUT,0,2,2,4,1912,Sweden
18,NED,0,0,3,3,1912,Sweden
1,USA,41,27,27,95,1920,Belgium
2,SWE,19,20,25,64,1920,Belgium
3,FIN,15,10,9,34,1920,Belgium
4,GBR,14,15,13,42,1920,Belgium
5,BEL,14,11,11,36,1920,Belgium
6,NOR,13,9,9,31,1920,Belgium
7,ITA,13,5,5,23,1920,Belgium
8,FRA,9,19,13,41,1920,Belgium
9,NED,4,2,5,11,1920,Belgium
10,DEN,3,9,1,13,1920,Belgium
11,RSA,3,4,3,10,1920,Belgium
12,CAN,3,3,3,9,1920,Belgium
13,SUI,2,2,7,11,1920,Belgium
14,EST,1,2,0,3,1920,Belgium
15,BRA,1,1,1,3,1920,Belgium
16,AUS,0,2,1,3,1920,Belgium
17,JPN,0,2,0,2,1920,Belgium
17,ESP,0,2,0,2,1920,Belgium
19,GRE,0,1,0,1,1920,Belgium
19,LUX,0,1,0,1,1920,Belgium
21,CZE,0,0,2,2,1920,Belgium
22,NZL,0,0,1,1,1920,Belgium
1,USA,45,27,27,99,1924,France
2,FIN,14,13,10,37,1924,France
3,FRA,13,15,10,38,1924,France
4,GBR,9,13,12,34,1924,France
5,ITA,8,3,5,16,1924,France
6,SUI,7,8,10,25,1924,France
7,NOR,5,2,3,10,1924,France
8,SWE,4,13,12,29,1924,France
9,NED,4,1,5,10,1924,France
10,BEL,3,7,3,13,1924,France
11,AUS,3,1,2,6,1924,France
12,DEN,2,5,2,9,1924,France
13,HUN,2,3,4,9,1924,France
14,YUG,2,0,0,2,1924,France
15,CZE,1,4,5,10,1924,France
16,ARG,1,3,2,6,1924,France
17,EST,1,1,4,6,1924,France
18,RSA,1,1,1,3,1924,France
19,URU,1,0,0,1,1924,France
20,AUT,0,3,1,4,1924,France
20,CAN,0,3,1,4,1924,France
22,POL,0,1,1,2,1924,France
23,HAI,0,0,1,1,1924,France
23,JPN,0,0,1,1,1924,France
23,NZL,0,0,1,1,1924,France
23,POR,0,0,1,1,1924,France
23,ROU,0,0,1,1,1924,France
1,USA,22,18,16,56,1928,Netherlands
2,GER,10,7,14,31,1928,Netherlands
3,FIN,8,8,9,25,1928,Netherlands
4,SWE,7,6,12,25,1928,Netherlands
5,ITA,7,5,7,19,1928,Netherlands
6,SUI,7,4,4,15,1928,Netherlands
7,FRA,6,10,5,21,1928,Netherlands
8,NED,6,9,4,19,1928,Netherlands
9,HUN,4,5,0,9,1928,Netherlands
10,CAN,4,4,7,15,1928,Netherlands
11,GBR,3,10,7,20,1928,Netherlands
12,ARG,3,3,1,7,1928,Netherlands
13,DEN,3,1,2,6,1928,Netherlands
14,CZE,2,5,2,9,1928,Netherlands
15,JPN,2,2,1,5,1928,Netherlands
16,EST,2,1,2,5,1928,Netherlands
17,EGY,2,1,1,4,1928,Netherlands
18,AUT,2,0,1,3,1928,Netherlands
19,AUS,1,2,1,4,1928,Netherlands
19,NOR,1,2,1,4,1928,Netherlands
21,POL,1,1,3,5,1928,Netherlands
21,YUG,1,1,3,5,1928,Netherlands
23,RSA,1,0,2,3,1928,Netherlands
24,IND,1,0,0,1,1928,Netherlands
24,IRL,1,0,0,1,1928,Netherlands
24,NZL,1,0,0,1,1928,Netherlands
24,ESP,1,0,0,1,1928,Netherlands
24,URU,1,0,0,1,1928,Netherlands
29,BEL,0,1,2,3,1928,Netherlands
30,CHI,0,1,0,1,1928,Netherlands
30,HAI,0,1,0,1,1928,Netherlands
32,PHI,0,0,1,1,1928,Netherlands
32,POR,0,0,1,1,1928,Netherlands
1,USA,44,36,30,110,1932,United States
2,ITA,12,12,12,36,1932,United States
3,FRA,11,5,4,20,1932,United States
4,SWE,10,5,9,24,1932,United States
5,JPN,7,7,4,18,1932,United States
6,HUN,6,5,5,16,1932,United States
7,GER,5,12,7,24,1932,United States
8,FIN,5,8,12,25,1932,United States
9,GBR,5,7,5,17,1932,United States
10,POL,3,2,4,9,1932,United States
11,AUS,3,1,1,5,1932,United States
12,AFG,3,1,0,4,1932,United States
13,CAN,2,5,9,16,1932,United States
14,NED,2,5,1,8,1932,United States
15,RSA,2,0,3,5,1932,United States
16,IRL,2,0,0,2,1932,United States
17,CZE,1,3,2,6,1932,United States
18,AUS,1,1,3,5,1932,United States
19,IND,1,0,0,1,1932,United States
20,DEN,0,5,3,8,1932,United States
21,MEX,0,2,0,2,1932,United States
22,LAT,0,1,0,1,1932,United States
22,NZL,0,1,0,1,1932,United States
22,SUIÂ ,0,1,0,1,1932,United States
25,PHI,0,0,3,3,1932,United States
26,BEL,0,0,1,1,1932,United States
26,ESP,0,0,1,1,1932,United States
26,URU,0,0,1,1,1932,United States
1,GER,38,31,32,101,1936,Germany
2,USA,24,21,12,57,1936,Germany
3,HUN,10,1,5,16,1936,Germany
4,ITA,9,13,5,27,1936,Germany
5,FIN,8,6,6,20,1936,Germany
6,FRA,7,6,6,19,1936,Germany
7,SWE,6,5,10,21,1936,Germany
8,JPN,6,4,10,20,1936,Germany
9,NED,6,4,7,17,1936,Germany
10,AUT,5,7,5,17,1936,Germany
11,SUI,4,9,5,18,1936,Germany
12,GBR,4,7,3,14,1936,Germany
13,CZE,3,5,1,9,1936,Germany
14,ARG,2,2,3,7,1936,Germany
14,EST,2,2,3,7,1936,Germany
16,EGY,2,1,2,5,1936,Germany
17,CAN,1,3,5,9,1936,Germany
18,NOR,1,3,2,6,1936,Germany
19,TUR,1,0,1,2,1936,Germany
20,IND,1,0,0,1,1936,Germany
20,NZL,1,0,0,1,1936,Germany
22,POL,0,4,5,9,1936,Germany
23,DEN,0,2,3,5,1936,Germany
24,LAT,0,1,1,2,1936,Germany
25,ROU,0,1,0,1,1936,Germany
25,RSA,0,1,0,1,1936,Germany
25,YUG,0,1,0,1,1936,Germany
28,BEL,0,0,3,3,1936,Germany
28,MEX,0,0,3,3,1936,Germany
30,AUS,0,0,1,1,1936,Germany
30,PHI,0,0,1,1,1936,Germany
30,POR,0,0,1,1,1936,Germany
1,USA,38,27,19,84,1948,United Kingdom
2,SWE,16,11,17,44,1948,United Kingdom
3,FRA,10,6,13,29,1948,United Kingdom
4,HUN,10,5,12,27,1948,United Kingdom
5,ITA,8,11,8,27,1948,United Kingdom
6,FIN,8,7,5,20,1948,United Kingdom
7,TUR,6,4,2,12,1948,United Kingdom
8,CZE,6,2,3,11,1948,United Kingdom
9,SUI,5,10,5,20,1948,United Kingdom
10,DEN,5,7,8,20,1948,United Kingdom
11,NED,5,2,9,16,1948,United Kingdom
12,GBR,3,14,6,23,1948,United Kingdom
13,ARG,3,3,1,7,1948,United Kingdom
14,AUS,2,6,5,13,1948,United Kingdom
15,BEL,2,2,3,7,1948,United Kingdom
16,EGY,2,2,1,5,1948,United Kingdom
17,MEX,2,1,2,5,1948,United Kingdom
18,RSA,2,1,1,4,1948,United Kingdom
19,NOR,1,3,3,7,1948,United Kingdom
20,JAM,1,2,0,3,1948,United Kingdom
21,AUT,1,0,3,4,1948,United Kingdom
22,IND,1,0,0,1,1948,United Kingdom
22,PER,1,0,0,1,1948,United Kingdom
24,YUG,0,2,0,2,1948,United Kingdom
25,CAN,0,1,2,3,1948,United Kingdom
26,POR,0,1,1,2,1948,United Kingdom
26,URU,0,1,1,2,1948,United Kingdom
28,Ceylon,0,1,0,1,1948,United Kingdom
28,CUB,0,1,0,1,1948,United Kingdom
28,ESP,0,1,0,1,1948,United Kingdom
28,TTO,0,1,0,1,1948,United Kingdom
32,PAN,0,0,2,2,1948,United Kingdom
32,KOR,0,0,2,2,1948,United Kingdom
34,BRA,0,0,1,1,1948,United Kingdom
34,IRI,0,0,1,1,1948,United Kingdom
34,POL,0,0,1,1,1948,United Kingdom
34,PUR,0,0,1,1,1948,United Kingdom
1,USA,40,19,17,76,1952,Finland
2,URS,22,30,19,71,1952,Finland
3,HUN,16,10,16,42,1952,Finland
4,SWE,12,13,10,35,1952,Finland
5,ITA,8,9,4,21,1952,Finland
6,CZE,7,3,3,13,1952,Finland
7,FRA,6,6,6,18,1952,Finland
8,FIN,6,3,13,22,1952,Finland
9,AUS,6,2,3,11,1952,Finland
10,NOR,3,2,0,5,1952,Finland
11,SUI,2,6,6,14,1952,Finland
12,RSA,2,4,4,10,1952,Finland
13,JAM,2,3,0,5,1952,Finland
14,BEL,2,2,0,4,1952,Finland
15,DEN,2,1,3,6,1952,Finland
16,TUR,2,0,1,3,1952,Finland
17,JPN,1,6,2,9,1952,Finland
18,GBR,1,2,8,11,1952,Finland
19,ARG,1,2,2,5,1952,Finland
20,POL,1,2,1,4,1952,Finland
21,CAN,1,2,0,3,1952,Finland
21,YUG,1,2,0,3,1952,Finland
23,ROU,1,1,2,4,1952,Finland
24,BRA,1,0,2,3,1952,Finland
24,NZL,1,0,2,3,1952,Finland
26,IND,1,0,1,2,1952,Finland
27,LUX,1,0,0,1,1952,Finland
28,GER,0,7,17,24,1952,Finland
29,NED,0,5,0,5,1952,Finland
30,IRI,0,3,4,7,1952,Finland
31,CHI,0,2,0,2,1952,Finland
32,AUT,0,1,1,2,1952,Finland
32,LBN,0,1,1,2,1952,Finland
34,IRL,0,1,0,1,1952,Finland
34,MEX,0,1,0,1,1952,Finland
34,ESP,0,1,0,1,1952,Finland
37,KOR,0,0,2,2,1952,Finland
37,TTO,0,0,2,2,1952,Finland
37,URU,0,0,2,2,1952,Finland
40,BUL,0,0,1,1,1952,Finland
40,EGY,0,0,1,1,1952,Finland
40,POR,0,0,1,1,1952,Finland
40,VEN,0,0,1,1,1952,Finland
1,URS,37,29,32,98,1956,Australia
2,USA,32,25,17,74,1956,Australia
3,AUS,13,8,14,35,1956,Australia
4,HUN,9,10,7,26,1956,Australia
5,ITA,8,8,9,25,1956,Australia
6,SWE,8,5,6,19,1956,Australia
7,EUN,6,13,7,26,1956,Australia
8,GBR,6,7,11,24,1956,Australia
9,ROU,5,3,5,13,1956,Australia
10,JPN,4,10,5,19,1956,Australia
11,FRA,4,4,6,14,1956,Australia
12,TUR,3,2,2,7,1956,Australia
13,FIN,3,1,11,15,1956,Australia
14,IRI,2,2,1,5,1956,Australia
15,CAN,2,1,3,6,1956,Australia
16,NZL,2,0,0,2,1956,Australia
17,POL,1,4,4,9,1956,Australia
18,CZE,1,4,1,6,1956,Australia
19,BUL,1,3,1,5,1956,Australia
20,DEN,1,2,1,4,1956,Australia
21,IRL,1,1,3,5,1956,Australia
22,NOR,1,0,2,3,1956,Australia
23,MEX,1,0,1,2,1956,Australia
24,BRA,1,0,0,1,1956,Australia
24,IND,1,0,0,1,1956,Australia
26,YUG,0,3,0,3,1956,Australia
27,CHI,0,2,2,4,1956,Australia
28,BEL,0,2,0,2,1956,Australia
29,ARG,0,1,1,2,1956,Australia
29,KOR,0,1,1,2,1956,Australia
31,ISL,0,1,0,1,1956,Australia
31,PAK,0,1,0,1,1956,Australia
33,RSA,0,0,4,4,1956,Australia
34,AUT,0,0,2,2,1956,Australia
35,BAH,0,0,1,1,1956,Australia
35,GRE,0,0,1,1,1956,Australia
35,SUI,0,0,1,1,1956,Australia
35,URU,0,0,1,1,1956,Australia
1,URS,43,29,31,103,1960,Italy
2,USA,34,21,16,71,1960,Italy
3,ITA,13,10,13,36,1960,Italy
4,EUN,12,19,11,42,1960,Italy
5,AUS,8,8,6,22,1960,Italy
6,TUR,7,2,0,9,1960,Italy
7,HUN,6,8,7,21,1960,Italy
8,JPN,4,7,7,18,1960,Italy
9,POL,4,6,11,21,1960,Italy
10,CZE,3,2,3,8,1960,Italy
11,ROU,3,1,6,10,1960,Italy
12,GBR,2,6,12,20,1960,Italy
13,DEN,2,3,1,6,1960,Italy
14,NZL,2,0,1,3,1960,Italy
15,BUL,1,3,3,7,1960,Italy
16,SWE,1,2,3,6,1960,Italy
17,FIN,1,1,3,5,1960,Italy
18,AUS,1,1,0,2,1960,Italy
18,YUG,1,1,0,2,1960,Italy
20,PAK,1,0,1,2,1960,Italy
21,ETH,1,0,0,1,1960,Italy
21,GRE,1,0,0,1,1960,Italy
21,NOR,1,0,0,1,1960,Italy
24,SUI,0,3,3,6,1960,Italy
25,FRA,0,2,3,5,1960,Italy
26,BEL,0,2,2,4,1960,Italy
27,IRI,0,1,3,4,1960,Italy
28,NED,0,1,2,3,1960,Italy
28,RSA,0,1,2,3,1960,Italy
30,AFG,0,1,1,2,1960,Italy
30,EGY,0,1,1,2,1960,Italy
32,CAN,0,1,0,1,1960,Italy
32,USA,0,1,0,1,1960,Italy
32,GHA,0,1,0,1,1960,Italy
32,IND,0,1,0,1,1960,Italy
32,MAR,0,1,0,1,1960,Italy
32,POR,0,1,0,1,1960,Italy
32,SGP,0,1,0,1,1960,Italy
39,BRA,0,0,2,2,1960,Italy
39,WIF,0,0,2,2,1960,Italy
41,IraqÂ ,0,0,1,1,1960,Italy
41,MEX,0,0,1,1,1960,Italy
41,ESP,0,0,1,1,1960,Italy
41,VEN,0,0,1,1,1960,Italy
1,USA,36,26,28,90,1964,Japan
2,URS,30,31,35,96,1964,Japan
3,JPN,16,5,8,29,1964,Japan
4,EUN,10,22,18,50,1964,Japan
5,ITA,10,10,7,27,1964,Japan
6,HUN,10,7,5,22,1964,Japan
7,POL,7,6,10,23,1964,Japan
8,AUS,6,2,10,18,1964,Japan
9,CZE,5,6,3,14,1964,Japan
10,GBR,4,12,2,18,1964,Japan
11,BUL,3,5,2,10,1964,Japan
12,FIN,3,0,2,5,1964,Japan
12,NZL,3,0,2,5,1964,Japan
14,ROU,2,4,6,12,1964,Japan
15,NED,2,4,4,10,1964,Japan
16,TUR,2,3,1,6,1964,Japan
17,SWE,2,2,4,8,1964,Japan
18,DEN,2,1,3,6,1964,Japan
19,YUG,2,1,2,5,1964,Japan
20,BEL,2,0,1,3,1964,Japan
21,FRA,1,8,6,15,1964,Japan
22,CAN,1,2,1,4,1964,Japan
22,SUI,1,2,1,4,1964,Japan
24,BAH,1,0,0,1,1964,Japan
24,ETH,1,0,0,1,1964,Japan
24,IND,1,0,0,1,1964,Japan
27,KOR,0,2,1,3,1964,Japan
28,TTO,0,1,2,3,1964,Japan
29,TUN,0,1,1,2,1964,Japan
30,ARG,0,1,0,1,1964,Japan
30,CUB,0,1,0,1,1964,Japan
30,PAK,0,1,0,1,1964,Japan
30,PHI,0,1,0,1,1964,Japan
34,IRI,0,0,2,2,1964,Japan
35,BRA,0,0,1,1,1964,Japan
35,GHA,0,0,1,1,1964,Japan
35,IRL,0,0,1,1,1964,Japan
35,KEN,0,0,1,1,1964,Japan
35,MEX,0,0,1,1,1964,Japan
35,NGR,0,0,1,1,1964,Japan
35,URU,0,0,1,1,1964,Japan
1,USA,45,28,34,107,1968,Mexico
2,URS,29,32,30,91,1968,Mexico
3,JPN,11,7,7,25,1968,Mexico
4,HUN,10,10,12,32,1968,Mexico
5,GDR,9,9,7,25,1968,Mexico
6,FRA,7,3,5,15,1968,Mexico
7,CZE,7,2,4,13,1968,Mexico
8,FRG,5,11,10,26,1968,Mexico
9,AUS,5,7,5,17,1968,Mexico
10,GBR,5,5,3,13,1968,Mexico
11,POL,5,2,11,18,1968,Mexico
12,ROU,4,6,5,15,1968,Mexico
13,ITA,3,4,9,16,1968,Mexico
14,KEN,3,4,2,9,1968,Mexico
15,MEX,3,3,3,9,1968,Mexico
16,YUG,3,3,2,8,1968,Mexico
17,NED,3,3,1,7,1968,Mexico
18,BUL,2,4,3,9,1968,Mexico
19,IRI,2,1,2,5,1968,Mexico
20,SWE,2,1,1,4,1968,Mexico
21,TUR,2,0,0,2,1968,Mexico
22,DEN,1,4,3,8,1968,Mexico
23,CAN,1,3,1,5,1968,Mexico
24,FIN,1,2,1,4,1968,Mexico
25,ETH,1,1,0,2,1968,Mexico
25,NOR,1,1,0,2,1968,Mexico
27,NZL,1,0,2,3,1968,Mexico
28,TUN,1,0,1,2,1968,Mexico
29,PAK,1,0,0,1,1968,Mexico
29,VEN,1,0,0,1,1968,Mexico
31,CUB,0,4,0,4,1968,Mexico
32,AUT,0,2,2,4,1968,Mexico
33,SUI,0,1,4,5,1968,Mexico
34,MGL,0,1,3,4,1968,Mexico
35,BRA,0,1,2,3,1968,Mexico
36,BEL,0,1,1,2,1968,Mexico
36,KOR,0,1,1,2,1968,Mexico
36,UGA,0,1,1,2,1968,Mexico
39,CMR,0,1,0,1,1968,Mexico
39,JAM,0,1,0,1,1968,Mexico
41,ARG,0,0,2,2,1968,Mexico
42,GRE,0,0,1,1,1968,Mexico
42,IND,0,0,1,1,1968,Mexico
42,Taiwan,0,0,1,1,1968,Mexico
1,URS,50,27,22,99,1972,West Germany
2,USA,33,31,30,94,1972,West Germany
3,GDR,20,23,23,66,1972,West Germany
4,FRG,13,11,16,40,1972,West Germany
5,JPN,13,8,8,29,1972,West Germany
6,AUS,8,7,2,17,1972,West Germany
7,POL,7,5,9,21,1972,West Germany
8,HUN,6,13,16,35,1972,West Germany
9,BUL,6,10,5,21,1972,West Germany
10,ITA,5,3,10,18,1972,West Germany
11,SWE,4,6,6,16,1972,West Germany
12,GBR,4,5,9,18,1972,West Germany
13,ROU,3,6,7,16,1972,West Germany
14,CUB,3,1,4,8,1972,West Germany
14,FIN,3,1,4,8,1972,West Germany
16,NED,3,1,1,5,1972,West Germany
17,FRA,2,4,7,13,1972,West Germany
18,CZE,2,4,2,8,1972,West Germany
19,KEN,2,3,4,9,1972,West Germany
20,YUG,2,1,2,5,1972,West Germany
21,NOR,2,1,1,4,1972,West Germany
22,PRK,1,1,3,5,1972,West Germany
23,NZL,1,1,1,3,1972,West Germany
24,UGA,1,1,0,2,1972,West Germany
25,DEN,1,0,0,1,1972,West Germany
26,SUI,0,3,0,3,1972,West Germany
27,CAN,0,2,3,5,1972,West Germany
28,IRI,0,2,1,3,1972,West Germany
29,BEL,0,2,0,2,1972,West Germany
29,GRE,0,2,0,2,1972,West Germany
31,AUT,0,1,2,3,1972,West Germany
31,COL,0,1,2,3,1972,West Germany
33,ARG,0,1,0,1,1972,West Germany
33,LBN,0,1,0,1,1972,West Germany
33,MEX,0,1,0,1,1972,West Germany
33,MGL,0,1,0,1,1972,West Germany
33,PAK,0,1,0,1,1972,West Germany
33,KOR,0,1,0,1,1972,West Germany
33,TUN,0,1,0,1,1972,West Germany
33,TUR,0,1,0,1,1972,West Germany
41,BRA,0,0,2,2,1972,West Germany
41,ETH,0,0,2,2,1972,West Germany
43,GHA,0,0,1,1,1972,West Germany
43,IND,0,0,1,1,1972,West Germany
43,JAM,0,0,1,1,1972,West Germany
43,NIG,0,0,1,1,1972,West Germany
43,NGR,0,0,1,1,1972,West Germany
43,ESP,0,0,1,1,1972,West Germany
1,URS,49,41,35,125,1976,Canada
2,GDR,40,25,25,90,1976,Canada
3,USA,34,35,25,94,1976,Canada
4,FRG,10,12,17,39,1976,Canada
5,JPN,9,6,10,25,1976,Canada
6,POL,7,6,13,26,1976,Canada
7,BUL,6,9,7,22,1976,Canada
8,CUB,6,4,3,13,1976,Canada
9,ROU,4,9,14,27,1976,Canada
10,HUN,4,5,13,22,1976,Canada
11,FIN,4,2,0,6,1976,Canada
12,SWE,4,1,0,5,1976,Canada
13,GBR,3,5,5,13,1976,Canada
14,ITA,2,7,4,13,1976,Canada
15,FRA,2,3,4,9,1976,Canada
16,YUG,2,3,3,8,1976,Canada
17,CZE,2,2,4,8,1976,Canada
18,NZL,2,1,1,4,1976,Canada
19,KOR,1,1,4,6,1976,Canada
20,SUI,1,1,2,4,1976,Canada
21,JAM,1,1,0,2,1976,Canada
21,PRK,1,1,0,2,1976,Canada
21,NOR,1,1,0,2,1976,Canada
24,DEN,1,0,2,3,1976,Canada
25,MEX,1,0,1,2,1976,Canada
26,TTO,1,0,0,1,1976,Canada
27,CAN,0,5,6,11,1976,Canada
28,BEL,0,3,3,6,1976,Canada
29,NED,0,2,3,5,1976,Canada
30,POR,0,2,0,2,1976,Canada
30,ESP,0,2,0,2,1976,Canada
32,AUS,0,1,4,5,1976,Canada
33,IRI,0,1,1,2,1976,Canada
34,MGL,0,1,0,1,1976,Canada
34,VEN,0,1,0,1,1976,Canada
36,BRA,0,0,2,2,1976,Canada
37,AUT,0,0,1,1,1976,Canada
37,BER,0,0,1,1,1976,Canada
37,PAK,0,0,1,1,1976,Canada
37,PUR,0,0,1,1,1976,Canada
37,THA,0,0,1,1,1976,Canada
1,URS,80,69,46,195,1980,Soviet Union
2,GDR,47,37,42,126,1980,Soviet Union
3,BUL,8,16,17,41,1980,Soviet Union
4,CUB,8,7,5,20,1980,Soviet Union
5,ITA,8,3,4,15,1980,Soviet Union
6,HUN,7,10,15,32,1980,Soviet Union
7,ROU,6,6,13,25,1980,Soviet Union
8,FRA,6,5,3,14,1980,Soviet Union
9,GBR,5,7,9,21,1980,Soviet Union
10,POL,3,14,15,32,1980,Soviet Union
11,SWE,3,3,6,12,1980,Soviet Union
12,FIN,3,1,4,8,1980,Soviet Union
13,CZE,2,3,9,14,1980,Soviet Union
14,YUG,2,3,4,9,1980,Soviet Union
15,AUS,2,2,5,9,1980,Soviet Union
16,DEN,2,1,2,5,1980,Soviet Union
17,BRA,2,0,2,4,1980,Soviet Union
17,ETH,2,0,2,4,1980,Soviet Union
19,SUI,2,0,0,2,1980,Soviet Union
20,ESP,1,3,2,6,1980,Soviet Union
21,AUT,1,2,1,4,1980,Soviet Union
22,GRE,1,0,2,3,1980,Soviet Union
23,BEL,1,0,0,1,1980,Soviet Union
23,IND,1,0,0,1,1980,Soviet Union
23,ZIM,1,0,0,1,1980,Soviet Union
26,PRK,0,3,2,5,1980,Soviet Union
27,MGL,0,2,2,4,1980,Soviet Union
28,TAN,0,2,0,2,1980,Soviet Union
29,MEX,0,1,3,4,1980,Soviet Union
30,NED,0,1,2,3,1980,Soviet Union
31,IRL,0,1,1,2,1980,Soviet Union
32,UGA,0,1,0,1,1980,Soviet Union
32,VEN,0,1,0,1,1980,Soviet Union
34,JAM,0,0,3,3,1980,Soviet Union
35,GUY,0,0,1,1,1980,Soviet Union
35,LBN,0,0,1,1,1980,Soviet Union
1,USA,83,61,30,174,1984,United States
2,ROU,20,16,17,53,1984,United States
3,FRG,17,19,23,59,1984,United States
4,CHN,15,8,9,32,1984,United States
5,ITA,14,6,12,32,1984,United States
6,CAN,10,18,16,44,1984,United States
7,JPN,10,8,14,32,1984,United States
8,NZL,8,1,2,11,1984,United States
9,YUG,7,4,7,18,1984,United States
10,KOR,6,6,7,19,1984,United States
11,GBR,5,11,21,37,1984,United States
12,FRA,5,7,16,28,1984,United States
13,NED,5,2,6,13,1984,United States
14,AUS,4,8,12,24,1984,United States
15,FIN,4,2,6,12,1984,United States
16,SWE,2,11,6,19,1984,United States
17,MEX,2,3,1,6,1984,United States
18,MAR,2,0,0,2,1984,United States
19,BRA,1,5,2,8,1984,United States
20,ESP,1,2,2,5,1984,United States
21,BEL,1,1,2,4,1984,United States
22,AUT,1,1,1,3,1984,United States
23,KEN,1,0,2,3,1984,United States
23,POR,1,0,2,3,1984,United States
25,PAK,1,0,0,1,1984,United States
26,SUI,0,4,4,8,1984,United States
27,DEN,0,3,3,6,1984,United States
28,JAM,0,1,2,3,1984,United States
28,NOR,0,1,2,3,1984,United States
30,GRE,0,1,1,2,1984,United States
30,NGR,0,1,1,2,1984,United States
30,PUR,0,1,1,2,1984,United States
33,COL,0,1,0,1,1984,United States
33,EGY,0,1,0,1,1984,United States
33,IRL,0,1,0,1,1984,United States
33,CIV,0,1,0,1,1984,United States
33,PER,0,1,0,1,1984,United States
33,SYR,0,1,0,1,1984,United States
33,THA,0,1,0,1,1984,United States
40,TUR,0,0,3,3,1984,United States
40,VEN,0,0,3,3,1984,United States
42,ALG,0,0,2,2,1984,United States
43,CMR,0,0,1,1,1984,United States
43,TPE,0,0,1,1,1984,United States
43,DOM,0,0,1,1,1984,United States
43,ISL,0,0,1,1,1984,United States
43,ZAM,0,0,1,1,1984,United States
1,URS,55,31,46,132,1988,South Korea
2,GDR,37,35,30,102,1988,South Korea
3,USA,36,31,27,94,1988,South Korea
4,KOR,12,10,11,33,1988,South Korea
5,FRG,11,14,15,40,1988,South Korea
6,HUN,11,6,6,23,1988,South Korea
7,BUL,10,12,13,35,1988,South Korea
8,ROU,7,11,6,24,1988,South Korea
9,FRA,6,4,6,16,1988,South Korea
10,ITA,6,4,4,14,1988,South Korea
11,CHN,5,11,12,28,1988,South Korea
12,GBR,5,10,9,24,1988,South Korea
13,KEN,5,2,2,9,1988,South Korea
14,JPN,4,3,7,14,1988,South Korea
15,AUS,3,6,5,14,1988,South Korea
16,YUG,3,4,5,12,1988,South Korea
17,CZE,3,3,2,8,1988,South Korea
18,NZL,3,2,8,13,1988,South Korea
19,CAN,3,2,5,10,1988,South Korea
20,POL,2,5,9,16,1988,South Korea
21,NOR,2,3,0,5,1988,South Korea
22,NED,2,2,5,9,1988,South Korea
23,DEN,2,1,1,4,1988,South Korea
24,BRA,1,2,3,6,1988,South Korea
25,FIN,1,1,2,4,1988,South Korea
25,ESP,1,1,2,4,1988,South Korea
27,TUR,1,1,0,2,1988,South Korea
28,MAR,1,0,2,3,1988,South Korea
29,AUT,1,0,0,1,1988,South Korea
29,POR,1,0,0,1,1988,South Korea
29,SUR,1,0,0,1,1988,South Korea
32,SWE,0,4,7,11,1988,South Korea
33,SUI,0,2,2,4,1988,South Korea
34,JAM,0,2,0,2,1988,South Korea
35,ARG,0,1,1,2,1988,South Korea
36,CHI,0,1,0,1,1988,South Korea
36,CRC,0,1,0,1,1988,South Korea
36,INA,0,1,0,1,1988,South Korea
36,IRI,0,1,0,1,1988,South Korea
36,AHO,0,1,0,1,1988,South Korea
36,PER,0,1,0,1,1988,South Korea
36,SEN,0,1,0,1,1988,South Korea
36,ISV,0,1,0,1,1988,South Korea
44,BEL,0,0,2,2,1988,South Korea
44,MEX,0,0,2,2,1988,South Korea
46,COL,0,0,1,1,1988,South Korea
46,DJI,0,0,1,1,1988,South Korea
46,GRE,0,0,1,1,1988,South Korea
46,MGL,0,0,1,1,1988,South Korea
46,PAK,0,0,1,1,1988,South Korea
46,PHI,0,0,1,1,1988,South Korea
46,THA,0,0,1,1,1988,South Korea
1,EUN,45,38,29,112,1992,Spain
2,USA,37,34,37,108,1992,Spain
3,GER,33,21,28,82,1992,Spain
4,CHN,16,22,16,54,1992,Spain
5,CUB,14,6,11,31,1992,Spain
6,ESP,13,7,2,22,1992,Spain
7,KOR,12,5,12,29,1992,Spain
8,HUN,11,12,7,30,1992,Spain
9,FRA,8,5,16,29,1992,Spain
10,AUS,7,9,11,27,1992,Spain
11,CAN,7,4,7,18,1992,Spain
12,ITA,6,5,8,19,1992,Spain
13,GBR,5,3,12,20,1992,Spain
14,ROU,4,6,8,18,1992,Spain
15,CZE,4,2,1,7,1992,Spain
16,PRK,4,0,5,9,1992,Spain
17,JPN,3,8,11,22,1992,Spain
18,BUL,3,7,6,16,1992,Spain
19,POL,3,6,10,19,1992,Spain
20,NED,2,6,7,15,1992,Spain
21,KEN,2,4,2,8,1992,Spain
22,NOR,2,4,1,7,1992,Spain
23,TUR,2,2,2,6,1992,Spain
24,INA,2,2,1,5,1992,Spain
25,BRA,2,1,0,3,1992,Spain
26,GRE,2,0,0,2,1992,Spain
27,SWE,1,7,4,12,1992,Spain
28,NZL,1,4,5,10,1992,Spain
29,FIN,1,2,2,5,1992,Spain
30,DEN,1,1,4,6,1992,Spain
31,MAR,1,1,1,3,1992,Spain
32,IRL,1,1,0,2,1992,Spain
33,ETH,1,0,2,3,1992,Spain
34,ALG,1,0,1,2,1992,Spain
34,EST,1,0,1,2,1992,Spain
34,LTU,1,0,1,2,1992,Spain
37,SUI,1,0,0,1,1992,Spain
38,JAM,0,3,1,4,1992,Spain
38,NGR,0,3,1,4,1992,Spain
40,LAT,0,2,1,3,1992,Spain
41,AUT,0,2,0,2,1992,Spain
41,NAM,0,2,0,2,1992,Spain
41,RSA,0,2,0,2,1992,Spain
44,BEL,0,1,2,3,1992,Spain
44,CRO,0,1,2,3,1992,Spain
44,Independent Olympic Participants,0,1,2,3,1992,Spain
44,IRI,0,1,2,3,1992,Spain
48,ISR,0,1,1,2,1992,Spain
49,TPE,0,1,0,1,1992,Spain
49,MEX,0,1,0,1,1992,Spain
49,PER,0,1,0,1,1992,Spain
52,MGL,0,0,2,2,1992,Spain
52,SLO,0,0,2,2,1992,Spain
54,ARG,0,0,1,1,1992,Spain
54,BAH,0,0,1,1,1992,Spain
54,COL,0,0,1,1,1992,Spain
54,GHA,0,0,1,1,1992,Spain
54,MAS,0,0,1,1,1992,Spain
54,PAK,0,0,1,1,1992,Spain
54,PHI,0,0,1,1,1992,Spain
54,PUR,0,0,1,1,1992,Spain
54,QAT,0,0,1,1,1992,Spain
54,SUR,0,0,1,1,1992,Spain
54,THA,0,0,1,1,1992,Spain
1,USA,44,32,25,101,1996,United States
2,RUS,26,21,16,63,1996,United States
3,GER,20,18,27,65,1996,United States
4,CHN,16,22,12,50,1996,United States
5,FRA,15,7,15,37,1996,United States
6,ITA,13,10,12,35,1996,United States
7,AUS,9,9,23,41,1996,United States
8,CUB,9,8,8,25,1996,United States
9,UKR,9,2,12,23,1996,United States
10,KOR,7,15,5,27,1996,United States
11,POL,7,5,5,17,1996,United States
12,HUN,7,4,10,21,1996,United States
13,ESP,5,6,6,17,1996,United States
14,ROU,4,7,9,20,1996,United States
15,NED,4,5,10,19,1996,United States
16,GRE,4,4,0,8,1996,United States
17,CZE,4,3,4,11,1996,United States
18,SUI,4,3,0,7,1996,United States
19,DEN,4,1,1,6,1996,United States
19,TUR,4,1,1,6,1996,United States
21,CAN,3,11,8,22,1996,United States
22,BUL,3,7,5,15,1996,United States
23,JPN,3,6,5,14,1996,United States
24,KAZ,3,4,4,11,1996,United States
25,BRA,3,3,9,15,1996,United States
26,NZL,3,2,1,6,1996,United States
27,RSA,3,1,1,5,1996,United States
28,IRL,3,0,1,4,1996,United States
29,SWE,2,4,2,8,1996,United States
30,NOR,2,2,3,7,1996,United States
31,BEL,2,2,2,6,1996,United States
32,NGR,2,1,3,6,1996,United States
33,PRK,2,1,2,5,1996,United States
34,ALG,2,0,1,3,1996,United States
34,ETH,2,0,1,3,1996,United States
36,GBR,1,8,6,15,1996,United States
37,BLR,1,6,8,15,1996,United States
38,KEN,1,4,3,8,1996,United States
39,JAM,1,3,2,6,1996,United States
40,FIN,1,2,1,4,1996,United States
41,YUG,1,1,2,4,1996,United States
41,INA,1,1,2,4,1996,United States
43,IRI,1,1,1,3,1996,United States
43,SVK,1,1,1,3,1996,United States
45,ARM,1,1,0,2,1996,United States
45,CRO,1,1,0,2,1996,United States
47,POR,1,0,1,2,1996,United States
47,THA,1,0,1,2,1996,United States
49,BDI,1,0,0,1,1996,United States
49,CRC,1,0,0,1,1996,United States
49,ECU,1,0,0,1,1996,United States
49,HKG,1,0,0,1,1996,United States
49,SYR,1,0,0,1,1996,United States
54,ARG,0,2,1,3,1996,United States
55,NAM,0,2,0,2,1996,United States
55,SLO,0,2,0,2,1996,United States
57,AUT,0,1,2,3,1996,United States
58,MAS,0,1,1,2,1996,United States
58,MDA,0,1,1,2,1996,United States
58,UZB,0,1,1,2,1996,United States
61,AZE,0,1,0,1,1996,United States
61,BAH,0,1,0,1,1996,United States
61,TPE,0,1,0,1,1996,United States
61,LAT,0,1,0,1,1996,United States
61,PHI,0,1,0,1,1996,United States
61,TGA,0,1,0,1,1996,United States
61,ZAM,0,1,0,1,1996,United States
68,GEO,0,0,2,2,1996,United States
68,MAR,0,0,2,2,1996,United States
68,TTO,0,0,2,2,1996,United States
71,IND,0,0,1,1,1996,United States
71,ISR,0,0,1,1,1996,United States
71,LTU,0,0,1,1,1996,United States
71,MEX,0,0,1,1,1996,United States
71,MGL,0,0,1,1,1996,United States
71,MOZ,0,0,1,1,1996,United States
71,PUR,0,0,1,1,1996,United States
71,TUN,0,0,1,1,1996,United States
71,UGA,0,0,1,1,1996,United States
1,USA,37,24,32,93,2000,Australia
2,RUS,32,28,29,89,2000,Australia
3,CHN,28,16,14,58,2000,Australia
4,AUS,16,25,17,58,2000,Australia
5,GER,13,17,26,56,2000,Australia
6,FRA,13,14,11,38,2000,Australia
7,ITA,13,8,13,34,2000,Australia
8,NED,12,9,4,25,2000,Australia
9,CUB,11,11,7,29,2000,Australia
10,GBR,11,10,7,28,2000,Australia
11,ROU,11,6,9,26,2000,Australia
12,KOR,8,10,10,28,2000,Australia
13,HUN,8,6,3,17,2000,Australia
14,POL,6,5,3,14,2000,Australia
15,JPN,5,8,5,18,2000,Australia
16,BUL,5,6,2,13,2000,Australia
17,GRE,4,6,3,13,2000,Australia
18,SWE,4,5,3,12,2000,Australia
19,NOR,4,3,3,10,2000,Australia
20,ETH,4,1,3,8,2000,Australia
21,UKR,3,10,10,23,2000,Australia
22,KAZ,3,4,0,7,2000,Australia
23,BLR,3,3,11,17,2000,Australia
24,CAN,3,3,8,14,2000,Australia
25,ESP,3,3,5,11,2000,Australia
26,TUR,3,0,2,5,2000,Australia
27,IRI,3,0,1,4,2000,Australia
28,CZE,2,3,3,8,2000,Australia
29,KEN,2,3,2,7,2000,Australia
30,DEN,2,3,1,6,2000,Australia
31,FIN,2,1,1,4,2000,Australia
32,AUT,2,1,0,3,2000,Australia
33,LTU,2,0,3,5,2000,Australia
34,AZE,2,0,1,3,2000,Australia
34,BAH,2,0,1,3,2000,Australia
36,SLO,2,0,0,2,2000,Australia
37,SUI,1,6,2,9,2000,Australia
38,INA,1,3,2,6,2000,Australia
39,SVK,1,3,1,5,2000,Australia
40,MEX,1,2,3,6,2000,Australia
41,NGR,1,2,0,3,2000,Australia
42,ALG,1,1,3,5,2000,Australia
43,UZB,1,1,2,4,2000,Australia
44,YUG,1,1,1,3,2000,Australia
44,LAT,1,1,1,3,2000,Australia
46,NZL,1,0,3,4,2000,Australia
47,EST,1,0,2,3,2000,Australia
47,THA,1,0,2,3,2000,Australia
49,CRO,1,0,1,2,2000,Australia
50,CMR,1,0,0,1,2000,Australia
50,COL,1,0,0,1,2000,Australia
50,MOZ,1,0,0,1,2000,Australia
53,BRA,0,6,6,12,2000,Australia
54,JAM,0,6,3,9,2000,Australia
55,BEL,0,2,3,5,2000,Australia
55,RSA,0,2,3,5,2000,Australia
57,ARG,0,2,2,4,2000,Australia
58,TPE,0,1,4,5,2000,Australia
58,MAR,0,1,4,5,2000,Australia
60,PRK,0,1,3,4,2000,Australia
61,MDA,0,1,1,2,2000,Australia
61,KSA,0,1,1,2,2000,Australia
61,TTO,0,1,1,2,2000,Australia
64,IRL,0,1,0,1,2000,Australia
64,SRI,0,1,0,1,2000,Australia
64,URU,0,1,0,1,2000,Australia
64,VIE,0,1,0,1,2000,Australia
68,GEO,0,0,6,6,2000,Australia
69,CRC,0,0,2,2,2000,Australia
69,POR,0,0,2,2,2000,Australia
71,ARM,0,0,1,1,2000,Australia
71,BAR,0,0,1,1,2000,Australia
71,CHI,0,0,1,1,2000,Australia
71,ISL,0,0,1,1,2000,Australia
71,IND,0,0,1,1,2000,Australia
71,ISR,0,0,1,1,2000,Australia
71,KUW,0,0,1,1,2000,Australia
71,KGZ,0,0,1,1,2000,Australia
71,MKD,0,0,1,1,2000,Australia
71,QAT,0,0,1,1,2000,Australia
1,USA,36,39,26,101,2004,Greece
2,CHN,32,17,14,63,2004,Greece
3,RUS,28,26,36,90,2004,Greece
4,AUS,17,16,17,50,2004,Greece
5,JPN,16,9,12,37,2004,Greece
6,GER,13,16,20,49,2004,Greece
7,FRA,11,9,13,33,2004,Greece
8,ITA,10,11,11,32,2004,Greece
9,KOR,9,12,9,30,2004,Greece
10,GBR,9,9,12,30,2004,Greece
11,CUB,9,7,11,27,2004,Greece
12,HUN,8,6,3,17,2004,Greece
13,UKR,8,5,9,22,2004,Greece
14,ROU,8,5,6,19,2004,Greece
15,GRE,6,6,4,16,2004,Greece
16,BRA,5,2,3,10,2004,Greece
17,NOR,5,0,1,6,2004,Greece
18,NED,4,9,9,22,2004,Greece
19,SWE,4,2,1,7,2004,Greece
20,ESP,3,11,6,20,2004,Greece
21,CAN,3,6,3,12,2004,Greece
22,TUR,3,3,4,10,2004,Greece
23,POL,3,2,5,10,2004,Greece
24,NZL,3,2,0,5,2004,Greece
25,THA,3,1,4,8,2004,Greece
26,BLR,2,5,6,13,2004,Greece
27,AUT,2,4,1,7,2004,Greece
28,ETH,2,3,2,7,2004,Greece
29,IRI,2,2,2,6,2004,Greece
29,SVK,2,2,2,6,2004,Greece
31,TPE,2,2,1,5,2004,Greece
32,GEO,2,2,0,4,2004,Greece
33,BUL,2,1,9,12,2004,Greece
34,DEN,2,1,5,8,2004,Greece
35,JAM,2,1,2,5,2004,Greece
35,UZB,2,1,2,5,2004,Greece
37,MAR,2,1,0,3,2004,Greece
38,ARG,2,0,4,6,2004,Greece
39,CHI,2,0,1,3,2004,Greece
40,KAZ,1,4,3,8,2004,Greece
41,KEN,1,4,2,7,2004,Greece
42,CZE,1,3,5,9,2004,Greece
43,RSA,1,3,2,6,2004,Greece
44,CRO,1,2,2,5,2004,Greece
45,LTU,1,2,0,3,2004,Greece
46,EGY,1,1,3,5,2004,Greece
46,SUI,1,1,3,5,2004,Greece
48,INA,1,1,2,4,2004,Greece
49,ZIM,1,1,1,3,2004,Greece
50,AZE,1,0,4,5,2004,Greece
51,BEL,1,0,2,3,2004,Greece
52,BAH,1,0,1,2,2004,Greece
52,ISR,1,0,1,2,2004,Greece
54,CMR,1,0,0,1,2004,Greece
54,DOM,1,0,0,1,2004,Greece
54,UAE,1,0,0,1,2004,Greece
57,PRK,0,4,1,5,2004,Greece
58,LAT,0,4,0,4,2004,Greece
59,MEX,0,3,1,4,2004,Greece
60,POR,0,2,1,3,2004,Greece
61,FIN,0,2,0,2,2004,Greece
61,SCG,0,2,0,2,2004,Greece
63,SLO,0,1,3,4,2004,Greece
64,EST,0,1,2,3,2004,Greece
65,HKG,0,1,0,1,2004,Greece
65,IND,0,1,0,1,2004,Greece
65,PAR,0,1,0,1,2004,Greece
68,COL,0,0,2,2,2004,Greece
68,NGR,0,0,2,2,2004,Greece
68,VEN,0,0,2,2,2004,Greece
71,ERI,0,0,1,1,2004,Greece
71,MGL,0,0,1,1,2004,Greece
71,SYR,0,0,1,1,2004,Greece
71,TTO,0,0,1,1,2004,Greece
1,CHN,48,22,30,100,2008,China
2,USA,36,39,37,112,2008,China
3,RUS,24,13,23,60,2008,China
4,GBR,19,13,19,51,2008,China
5,GER,16,11,14,41,2008,China
6,AUS,14,15,17,46,2008,China
7,KOR,13,11,8,32,2008,China
8,JPN,9,8,8,25,2008,China
9,ITA,8,9,10,27,2008,China
10,FRA,7,16,20,43,2008,China
11,NED,7,5,4,16,2008,China
12,UKR,7,4,11,22,2008,China
13,KEN,6,4,6,16,2008,China
14,ESP,5,11,3,19,2008,China
15,JAM,5,4,2,11,2008,China
16,POL,4,5,2,11,2008,China
17,ETH,4,2,1,7,2008,China
18,ROU,4,1,4,9,2008,China
19,CUB,3,10,17,30,2008,China
20,CAN,3,9,8,20,2008,China
21,HUN,3,5,2,10,2008,China
22,NOR,3,5,1,9,2008,China
23,BRA,3,4,10,17,2008,China
24,BLR,3,4,7,14,2008,China
25,CZE,3,3,1,7,2008,China
26,SVK,3,3,0,6,2008,China
27,NZL,3,2,4,9,2008,China
28,GEO,3,2,2,7,2008,China
29,KAZ,2,3,4,9,2008,China
30,DEN,2,2,3,7,2008,China
31,PRK,2,2,2,6,2008,China
31,THA,2,2,2,6,2008,China
33,MGL,2,2,0,4,2008,China
34,SUI,2,1,4,7,2008,China
35,ARG,2,0,4,6,2008,China
36,MEX,2,0,2,4,2008,China
37,BEL,2,0,0,2,2008,China
38,ZIM,1,3,0,4,2008,China
39,SLO,1,2,2,5,2008,China
40,AZE,1,1,4,6,2008,China
40,INA,1,1,4,6,2008,China
42,BUL,1,1,3,5,2008,China
42,TUR,1,1,3,5,2008,China
44,TPE,1,1,2,4,2008,China
44,FIN,1,1,2,4,2008,China
46,LAT,1,1,1,3,2008,China
47,DOM,1,1,0,2,2008,China
47,EST,1,1,0,2,2008,China
47,POR,1,1,0,2,2008,China
47,TTO,1,1,0,2,2008,China
51,IND,1,0,2,3,2008,China
52,IRI,1,0,1,2,2008,China
53,CMR,1,0,0,1,2008,China
53,PAN,1,0,0,1,2008,China
53,TUN,1,0,0,1,2008,China
56,SWE,0,4,1,5,2008,China
57,LTU,0,3,2,5,2008,China
57,NGR,0,3,2,5,2008,China
59,CRO,0,2,3,5,2008,China
60,COL,0,2,1,3,2008,China
60,GRE,0,2,1,3,2008,China
62,ARM,0,1,4,5,2008,China
63,UZB,0,1,3,4,2008,China
64,AUT,0,1,2,3,2008,China
64,IRL,0,1,2,3,2008,China
64,KGZ,0,1,2,3,2008,China
64,SRB,0,1,2,3,2008,China
68,ALG,0,1,1,2,2008,China
68,BAH,0,1,1,2,2008,China
68,MAR,0,1,1,2,2008,China
68,TJK,0,1,1,2,2008,China
72,CHI,0,1,0,1,2008,China
72,ECU,0,1,0,1,2008,China
72,ISL,0,1,0,1,2008,China
72,MAS,0,1,0,1,2008,China
72,SAM,0,1,0,1,2008,China
72,SGP,0,1,0,1,2008,China
72,RSA,0,1,0,1,2008,China
72,SUD,0,1,0,1,2008,China
72,VIE,0,1,0,1,2008,China
81,EGY,0,0,2,2,2008,China
82,AFG,0,0,1,1,2008,China
82,ISR,0,0,1,1,2008,China
82,MRI,0,0,1,1,2008,China
82,MDA,0,0,1,1,2008,China
82,TOG,0,0,1,1,2008,China
82,VEN,0,0,1,1,2008,China
1,USA,48,26,30,104,2012,United Kingdom
2,CHN,39,31,22,92,2012,United Kingdom
3,GBR,29,18,18,65,2012,United Kingdom
4,RUS,18,21,26,65,2012,United Kingdom
5,KOR,13,9,9,31,2012,United Kingdom
6,GER,11,20,13,44,2012,United Kingdom
7,FRA,11,11,13,35,2012,United Kingdom
8,AUS,8,15,12,35,2012,United Kingdom
9,ITA,8,9,11,28,2012,United Kingdom
10,HUN,8,4,6,18,2012,United Kingdom
11,JPN,7,14,17,38,2012,United Kingdom
12,IRI,7,5,1,13,2012,United Kingdom
13,NED,6,6,8,20,2012,United Kingdom
14,NZL,6,2,5,13,2012,United Kingdom
15,UKR,5,4,10,19,2012,United Kingdom
16,CUB,5,3,7,15,2012,United Kingdom
17,ESP,4,10,6,20,2012,United Kingdom
18,JAM,4,5,4,13,2012,United Kingdom
19,CZE,4,4,3,11,2012,United Kingdom
20,RSA,4,1,1,6,2012,United Kingdom
21,PRK,4,0,2,6,2012,United Kingdom
22,BRA,3,5,9,17,2012,United Kingdom
23,KAZ,3,2,6,11,2012,United Kingdom
23,POL,3,2,6,11,2012,United Kingdom
25,ETH,3,2,3,8,2012,United Kingdom
26,CRO,3,1,2,6,2012,United Kingdom
27,CAN,2,6,10,18,2012,United Kingdom
28,BLR,2,5,3,10,2012,United Kingdom
29,KEN,2,4,7,13,2012,United Kingdom
30,DEN,2,4,3,9,2012,United Kingdom
31,ROU,2,4,1,7,2012,United Kingdom
32,AZE,2,2,5,9,2012,United Kingdom
33,SUI,2,2,0,4,2012,United Kingdom
34,NOR,2,1,1,4,2012,United Kingdom
35,LTU,2,0,3,5,2012,United Kingdom
36,TUN,2,0,1,3,2012,United Kingdom
37,SWE,1,4,3,8,2012,United Kingdom
38,COL,1,3,5,9,2012,United Kingdom
39,MEX,1,3,4,8,2012,United Kingdom
40,GEO,1,2,3,6,2012,United Kingdom
41,IRL,1,1,4,6,2012,United Kingdom
42,ARG,1,1,2,4,2012,United Kingdom
42,SRB,1,1,2,4,2012,United Kingdom
42,SLO,1,1,2,4,2012,United Kingdom
42,TTO,1,1,2,4,2012,United Kingdom
46,TUR,1,1,1,3,2012,United Kingdom
47,DOM,1,1,0,2,2012,United Kingdom
48,TPE,1,0,1,2,2012,United Kingdom
48,LAT,1,0,1,2,2012,United Kingdom
50,ALG,1,0,0,1,2012,United Kingdom
50,BAH,1,0,0,1,2012,United Kingdom
50,BRN,1,0,0,1,2012,United Kingdom
50,GRN,1,0,0,1,2012,United Kingdom
50,UGA,1,0,0,1,2012,United Kingdom
50,VEN,1,0,0,1,2012,United Kingdom
56,EGY,0,3,1,4,2012,United Kingdom
57,IND,0,2,4,6,2012,United Kingdom
58,MGL,0,2,3,5,2012,United Kingdom
59,THA,0,2,2,4,2012,United Kingdom
60,BUL,0,2,1,3,2012,United Kingdom
60,FIN,0,2,1,3,2012,United Kingdom
60,INA,0,2,1,3,2012,United Kingdom
63,SVK,0,1,3,4,2012,United Kingdom
64,BEL,0,1,2,3,2012,United Kingdom
65,ARM,0,1,1,2,2012,United Kingdom
65,EST,0,1,1,2,2012,United Kingdom
65,MAS,0,1,1,2,2012,United Kingdom
65,PUR,0,1,1,2,2012,United Kingdom
65,QAT,0,1,1,2,2012,United Kingdom
70,BOT,0,1,0,1,2012,United Kingdom
70,CYP,0,1,0,1,2012,United Kingdom
70,GAB,0,1,0,1,2012,United Kingdom
70,GUA,0,1,0,1,2012,United Kingdom
70,MNE,0,1,0,1,2012,United Kingdom
70,POR,0,1,0,1,2012,United Kingdom
76,UZB,0,0,3,3,2012,United Kingdom
77,GRE,0,0,2,2,2012,United Kingdom
77,SGP,0,0,2,2,2012,United Kingdom
79,AFG,0,0,1,1,2012,United Kingdom
79,CMR,0,0,1,1,2012,United Kingdom
79,HKG,0,0,1,1,2012,United Kingdom
79,KUW,0,0,1,1,2012,United Kingdom
79,MAR,0,0,1,1,2012,United Kingdom
79,KSA,0,0,1,1,2012,United Kingdom
79,TJK,0,0,1,1,2012,United Kingdom
79,VIE,0,0,1,1,2012,United Kingdom
1,USA,46,37,38,121,2016,Brazil
2,GBR,27,23,17,67,2016,Brazil
3,CHN,26,18,26,70,2016,Brazil
4,RUS,19,17,20,56,2016,Brazil
5,GER,17,10,15,42,2016,Brazil
6,JPN,12,8,21,41,2016,Brazil
7,FRA,10,18,14,42,2016,Brazil
8,KOR,9,3,9,21,2016,Brazil
9,ITA,8,12,8,28,2016,Brazil
10,AUS,8,11,10,29,2016,Brazil
11,NED,8,7,4,19,2016,Brazil
12,HUN,8,3,4,15,2016,Brazil
13,BRA,7,6,6,19,2016,Brazil
14,ESP,7,4,6,17,2016,Brazil
15,KEN,6,6,1,13,2016,Brazil
16,JAM,6,3,2,11,2016,Brazil
17,CRO,5,3,2,10,2016,Brazil
18,CUB,5,2,4,11,2016,Brazil
19,NZL,4,9,5,18,2016,Brazil
20,CAN,4,3,15,22,2016,Brazil
21,UZB,4,2,7,13,2016,Brazil
22,COL,3,2,3,8,2016,Brazil
23,SUI,3,2,2,7,2016,Brazil
24,IRI,3,1,4,8,2016,Brazil
25,GRE,3,1,2,6,2016,Brazil
26,ARG,3,1,0,4,2016,Brazil
27,DEN,2,6,7,15,2016,Brazil
28,SWE,2,6,3,11,2016,Brazil
29,RSA,2,6,2,10,2016,Brazil
30,KAZ,2,5,10,17,2016,Brazil
31,UKR,2,5,4,11,2016,Brazil
32,SRB,2,4,2,8,2016,Brazil
33,POL,2,3,6,11,2016,Brazil
34,PRK,2,3,2,7,2016,Brazil
35,BEL,2,2,2,6,2016,Brazil
35,THA,2,2,2,6,2016,Brazil
37,SVK,2,2,0,4,2016,Brazil
38,GEO,2,1,4,7,2016,Brazil
39,AZE,1,7,10,18,2016,Brazil
40,BLR,1,4,4,9,2016,Brazil
41,TUR,1,3,4,8,2016,Brazil
42,ARM,1,3,0,4,2016,Brazil
43,CZE,1,2,7,10,2016,Brazil
44,ETH,1,2,5,8,2016,Brazil
45,SLO,1,2,1,4,2016,Brazil
46,INA,1,2,0,3,2016,Brazil
47,ROU,1,1,2,4,2016,Brazil
48,BRN,1,1,0,2,2016,Brazil
48,VIE,1,1,0,2,2016,Brazil
50,TPE,1,0,2,3,2016,Brazil
51,BAH,1,0,1,2,2016,Brazil
51,Independent Olympic Athletes,1,0,1,2,2016,Brazil
51,CIV,1,0,1,2,2016,Brazil
54,FIJ,1,0,0,1,2016,Brazil
54,JOR,1,0,0,1,2016,Brazil
54,KOS,1,0,0,1,2016,Brazil
54,PUR,1,0,0,1,2016,Brazil
54,SGP,1,0,0,1,2016,Brazil
54,TJK,1,0,0,1,2016,Brazil
60,MAS,0,4,1,5,2016,Brazil
61,MEX,0,3,2,5,2016,Brazil
62,VEN,0,2,1,3,2016,Brazil
63,ALG,0,2,0,2,2016,Brazil
63,IRL,0,2,0,2,2016,Brazil
65,LTU,0,1,3,4,2016,Brazil
66,BUL,0,1,2,3,2016,Brazil
67,IND,0,1,1,2,2016,Brazil
67,MGL,0,1,1,2,2016,Brazil
69,BDI,0,1,0,1,2016,Brazil
69,GRN,0,1,0,1,2016,Brazil
69,NIG,0,1,0,1,2016,Brazil
69,PHI,0,1,0,1,2016,Brazil
69,QAT,0,1,0,1,2016,Brazil
74,NOR,0,0,4,4,2016,Brazil
75,EGY,0,0,3,3,2016,Brazil
75,TUN,0,0,3,3,2016,Brazil
77,ISR,0,0,2,2,2016,Brazil
78,AUT,0,0,1,1,2016,Brazil
78,DOM,0,0,1,1,2016,Brazil
78,EST,0,0,1,1,2016,Brazil
78,FIN,0,0,1,1,2016,Brazil
78,MAR,0,0,1,1,2016,Brazil
78,NGR,0,0,1,1,2016,Brazil
78,POR,0,0,1,1,2016,Brazil
78,TTO,0,0,1,1,2016,Brazil
78,UAE,0,0,1,1,2016,Brazil
1,USA,39,41,33,113,2020,Japan (Postponed To 2021 Due To The Coronavirus Pandemic)
2,CHN,38,32,19,89,2020,Japan (Postponed To 2021 Due To The Coronavirus Pandemic)
3,JPN,27,14,17,58,2020,Japan (Postponed To 2021 Due To The Coronavirus Pandemic)
4,GBR,22,20,22,64,2020,Japan (Postponed To 2021 Due To The Coronavirus Pandemic)
5,ROC,20,28,23,71,2020,Japan (Postponed To 2021 Due To The Coronavirus Pandemic)
6,AUS,17,7,22,46,2020,Japan (Postponed To 2021 Due To The Coronavirus Pandemic)
7,NED,10,12,14,36,2020,Japan (Postponed To 2021 Due To The Coronavirus Pandemic)
8,FRA,10,12,11,33,2020,Japan (Postponed To 2021 Due To The Coronavirus Pandemic)
9,GER,10,11,16,37,2020,Japan (Postponed To 2021 Due To The Coronavirus Pandemic)
10,ITA,10,10,20,40,2020,Japan (Postponed To 2021 Due To The Coronavirus Pandemic)
11,CAN,7,7,10,24,2020,Japan (Postponed To 2021 Due To The Coronavirus Pandemic)
12,BRA,7,6,8,21,2020,Japan (Postponed To 2021 Due To The Coronavirus Pandemic)
13,NZL,7,6,7,20,2020,Japan (Postponed To 2021 Due To The Coronavirus Pandemic)
14,CUB,7,3,5,15,2020,Japan (Postponed To 2021 Due To The Coronavirus Pandemic)
15,HUN,6,7,7,20,2020,Japan (Postponed To 2021 Due To The Coronavirus Pandemic)
16,KOR,6,4,10,20,2020,Japan (Postponed To 2021 Due To The Coronavirus Pandemic)
17,POL,4,5,5,14,2020,Japan (Postponed To 2021 Due To The Coronavirus Pandemic)
18,CZE,4,4,3,11,2020,Japan (Postponed To 2021 Due To The Coronavirus Pandemic)
19,KEN,4,4,2,10,2020,Japan (Postponed To 2021 Due To The Coronavirus Pandemic)
20,NOR,4,2,2,8,2020,Japan (Postponed To 2021 Due To The Coronavirus Pandemic)
21,JAM,4,1,4,9,2020,Japan (Postponed To 2021 Due To The Coronavirus Pandemic)
22,ESP,3,8,6,17,2020,Japan (Postponed To 2021 Due To The Coronavirus Pandemic)
23,SWE,3,6,0,9,2020,Japan (Postponed To 2021 Due To The Coronavirus Pandemic)
24,SUI,3,4,6,13,2020,Japan (Postponed To 2021 Due To The Coronavirus Pandemic)
25,DEN,3,4,4,11,2020,Japan (Postponed To 2021 Due To The Coronavirus Pandemic)
26,CRO,3,3,2,8,2020,Japan (Postponed To 2021 Due To The Coronavirus Pandemic)
27,IRI,3,2,2,7,2020,Japan (Postponed To 2021 Due To The Coronavirus Pandemic)
28,SRB,3,1,5,9,2020,Japan (Postponed To 2021 Due To The Coronavirus Pandemic)
29,BEL,3,1,3,7,2020,Japan (Postponed To 2021 Due To The Coronavirus Pandemic)
30,BUL,3,1,2,6,2020,Japan (Postponed To 2021 Due To The Coronavirus Pandemic)
31,SLO,3,1,1,5,2020,Japan (Postponed To 2021 Due To The Coronavirus Pandemic)
32,UZB,3,0,2,5,2020,Japan (Postponed To 2021 Due To The Coronavirus Pandemic)
33,GEO,2,5,1,8,2020,Japan (Postponed To 2021 Due To The Coronavirus Pandemic)
34,TPE,2,4,6,12,2020,Japan (Postponed To 2021 Due To The Coronavirus Pandemic)
35,TUR,2,2,9,13,2020,Japan (Postponed To 2021 Due To The Coronavirus Pandemic)
36,GRE,2,1,1,4,2020,Japan (Postponed To 2021 Due To The Coronavirus Pandemic)
36,UGA,2,1,1,4,2020,Japan (Postponed To 2021 Due To The Coronavirus Pandemic)
38,ECU,2,1,0,3,2020,Japan (Postponed To 2021 Due To The Coronavirus Pandemic)
39,IRL,2,0,2,4,2020,Japan (Postponed To 2021 Due To The Coronavirus Pandemic)
39,ISR,2,0,2,4,2020,Japan (Postponed To 2021 Due To The Coronavirus Pandemic)
41,QAT,2,0,1,3,2020,Japan (Postponed To 2021 Due To The Coronavirus Pandemic)
42,BAH,2,0,0,2,2020,Japan (Postponed To 2021 Due To The Coronavirus Pandemic)
42,KOS,2,0,0,2,2020,Japan (Postponed To 2021 Due To The Coronavirus Pandemic)
44,UKR,1,6,12,19,2020,Japan (Postponed To 2021 Due To The Coronavirus Pandemic)
45,BLR,1,3,3,7,2020,Japan (Postponed To 2021 Due To The Coronavirus Pandemic)
46,ROU,1,3,0,4,2020,Japan (Postponed To 2021 Due To The Coronavirus Pandemic)
46,VEN,1,3,0,4,2020,Japan (Postponed To 2021 Due To The Coronavirus Pandemic)
48,IND,1,2,4,7,2020,Japan (Postponed To 2021 Due To The Coronavirus Pandemic)
49,HKG,1,2,3,6,2020,Japan (Postponed To 2021 Due To The Coronavirus Pandemic)
50,PHI,1,2,1,4,2020,Japan (Postponed To 2021 Due To The Coronavirus Pandemic)
50,SVK,1,2,1,4,2020,Japan (Postponed To 2021 Due To The Coronavirus Pandemic)
52,RSA,1,2,0,3,2020,Japan (Postponed To 2021 Due To The Coronavirus Pandemic)
53,AUT,1,1,5,7,2020,Japan (Postponed To 2021 Due To The Coronavirus Pandemic)
54,EGY,1,1,4,6,2020,Japan (Postponed To 2021 Due To The Coronavirus Pandemic)
55,INA,1,1,3,5,2020,Japan (Postponed To 2021 Due To The Coronavirus Pandemic)
56,ETH,1,1,2,4,2020,Japan (Postponed To 2021 Due To The Coronavirus Pandemic)
56,POR,1,1,2,4,2020,Japan (Postponed To 2021 Due To The Coronavirus Pandemic)
58,TUN,1,1,0,2,2020,Japan (Postponed To 2021 Due To The Coronavirus Pandemic)
59,EST,1,0,1,2,2020,Japan (Postponed To 2021 Due To The Coronavirus Pandemic)
59,FIJ,1,0,1,2,2020,Japan (Postponed To 2021 Due To The Coronavirus Pandemic)
59,LAT,1,0,1,2,2020,Japan (Postponed To 2021 Due To The Coronavirus Pandemic)
59,THA,1,0,1,2,2020,Japan (Postponed To 2021 Due To The Coronavirus Pandemic)
63,BER,1,0,0,1,2020,Japan (Postponed To 2021 Due To The Coronavirus Pandemic)
63,MAR,1,0,0,1,2020,Japan (Postponed To 2021 Due To The Coronavirus Pandemic)
63,PUR,1,0,0,1,2020,Japan (Postponed To 2021 Due To The Coronavirus Pandemic)
66,COL,0,4,1,5,2020,Japan (Postponed To 2021 Due To The Coronavirus Pandemic)
67,AZE,0,3,4,7,2020,Japan (Postponed To 2021 Due To The Coronavirus Pandemic)
68,DOM,0,3,2,5,2020,Japan (Postponed To 2021 Due To The Coronavirus Pandemic)
69,ARM,0,2,2,4,2020,Japan (Postponed To 2021 Due To The Coronavirus Pandemic)
70,KGZ,0,2,1,3,2020,Japan (Postponed To 2021 Due To The Coronavirus Pandemic)
71,MGL,0,1,3,4,2020,Japan (Postponed To 2021 Due To The Coronavirus Pandemic)
72,ARG,0,1,2,3,2020,Japan (Postponed To 2021 Due To The Coronavirus Pandemic)
72,SMR,0,1,2,3,2020,Japan (Postponed To 2021 Due To The Coronavirus Pandemic)
74,JOR,0,1,1,2,2020,Japan (Postponed To 2021 Due To The Coronavirus Pandemic)
74,MAS,0,1,1,2,2020,Japan (Postponed To 2021 Due To The Coronavirus Pandemic)
74,NGR,0,1,1,2,2020,Japan (Postponed To 2021 Due To The Coronavirus Pandemic)
77,BRN,0,1,0,1,2020,Japan (Postponed To 2021 Due To The Coronavirus Pandemic)
77,LTU,0,1,0,1,2020,Japan (Postponed To 2021 Due To The Coronavirus Pandemic)
77,NAM,0,1,0,1,2020,Japan (Postponed To 2021 Due To The Coronavirus Pandemic)
77,MKD,0,1,0,1,2020,Japan (Postponed To 2021 Due To The Coronavirus Pandemic)
77,KSA,0,1,0,1,2020,Japan (Postponed To 2021 Due To The Coronavirus Pandemic)
77,TKM,0,1,0,1,2020,Japan (Postponed To 2021 Due To The Coronavirus Pandemic)
83,KAZ,0,0,8,8,2020,Japan (Postponed To 2021 Due To The Coronavirus Pandemic)
84,MEX,0,0,4,4,2020,Japan (Postponed To 2021 Due To The Coronavirus Pandemic)
85,FIN,0,0,2,2,2020,Japan (Postponed To 2021 Due To The Coronavirus Pandemic)
86,BOT,0,0,1,1,2020,Japan (Postponed To 2021 Due To The Coronavirus Pandemic)
86,BUR,0,0,1,1,2020,Japan (Postponed To 2021 Due To The Coronavirus Pandemic)
86,GHA,0,0,1,1,2020,Japan (Postponed To 2021 Due To The Coronavirus Pandemic)
86,GRN,0,0,1,1,2020,Japan (Postponed To 2021 Due To The Coronavirus Pandemic)
86,CIV,0,0,1,1,2020,Japan (Postponed To 2021 Due To The Coronavirus Pandemic)
86,KUW,0,0,1,1,2020,Japan (Postponed To 2021 Due To The Coronavirus Pandemic)
86,MDA,0,0,1,1,2020,Japan (Postponed To 2021 Due To The Coronavirus Pandemic)
86,SYR,0,0,1,1,2020,Japan (Postponed To 2021 Due To The Coronavirus Pandemic)
1,USA,40,44,42,126,2024,France
2,CHN,40,27,24,91,2024,France
3,JPN,20,12,13,45,2024,France
4,AUS,18,19,16,53,2024,France
5,FRA,16,26,22,64,2024,France
6,NED,15,7,12,34,2024,France
7,GBR,14,22,29,65,2024,France
8,KOR,13,9,10,32,2024,France
9,ITA,12,13,15,40,2024,France
10,GER,12,13,8,33,2024,France
11,NZL,10,7,3,20,2024,France
12,CAN,9,7,11,27,2024,France
13,UZB,8,2,3,13,2024,France
14,HUN,6,7,6,19,2024,France
15,ESP,5,4,9,18,2024,France
16,SWE,4,4,3,11,2024,France
17,KEN,4,2,5,11,2024,France
18,NOR,4,1,3,8,2024,France
19,IRL,4,0,3,7,2024,France
20,BRA,3,7,10,20,2024,France
21,IRI,3,6,3,12,2024,France
22,UKR,3,5,4,12,2024,France
23,ROU,3,4,2,9,2024,France
24,GEO,3,3,1,7,2024,France
25,BEL,3,1,6,10,2024,France
26,BUL,3,1,3,7,2024,France
27,SRB,3,1,1,5,2024,France
28,CZE,3,0,2,5,2024,France
29,DEN,2,2,5,9,2024,France
30,AZE,2,2,3,7,2024,France
30,CRO,2,2,3,7,2024,France
32,CUB,2,1,6,9,2024,France
33,BRN,2,1,1,4,2024,France
34,SLO,2,1,0,3,2024,France
35,TPE,2,0,5,7,2024,France
36,AUT,2,0,3,5,2024,France
37,HKG,2,0,2,4,2024,France
37,PHI,2,0,2,4,2024,France
39,ALG,2,0,1,3,2024,France
39,INA,2,0,1,3,2024,France
41,ISR,1,5,1,7,2024,France
42,POL,1,4,5,10,2024,France
43,KAZ,1,3,3,7,2024,France
44,JAM,1,3,2,6,2024,France
44,RSA,1,3,2,6,2024,France
44,THA,1,3,2,6,2024,France
47,ETH,1,3,0,4,2024,France
48,SUI,1,2,5,8,2024,France
49,ECU,1,2,2,5,2024,France
50,POR,1,2,1,4,2024,France
51,GRE,1,1,6,8,2024,France
52,ARG,1,1,1,3,2024,France
52,EGY,1,1,1,3,2024,France
52,TUN,1,1,1,3,2024,France
55,BOT,1,1,0,2,2024,France
55,CHI,1,1,0,2,2024,France
55,LCA,1,1,0,2,2024,France
55,UGA,1,1,0,2,2024,France
59,DOM,1,0,2,3,2024,France
60,GUA,1,0,1,2,2024,France
60,MAR,1,0,1,2,2024,France
62,DMA,1,0,0,1,2024,France
62,PAK,1,0,0,1,2024,France
64,TUR,0,3,5,8,2024,France
65,MEX,0,3,2,5,2024,France
66,ARM,0,3,1,4,2024,France
66,COL,0,3,1,4,2024,France
68,KGZ,0,2,4,6,2024,France
68,PRK,0,2,4,6,2024,France
70,LTU,0,2,2,4,2024,France
71,IND,0,1,5,6,2024,France
72,MDA,0,1,3,4,2024,France
73,KOS,0,1,1,2,2024,France
74,CYP,0,1,0,1,2024,France
74,FIJ,0,1,0,1,2024,France
74,JOR,0,1,0,1,2024,France
74,MGL,0,1,0,1,2024,France
74,PAN,0,1,0,1,2024,France
79,TJK,0,0,3,3,2024,France
80,ALB,0,0,2,2,2024,France
80,GRN,0,0,2,2,2024,France
80,MAS,0,0,2,2,2024,France
80,PUR,0,0,2,2,2024,France
84,CPV,0,0,1,1,2024,France
84,CIV,0,0,1,1,2024,France
84,PER,0,0,1,1,2024,France
84,QAT,0,0,1,1,2024,France
84,EOR,0,0,1,1,2024,France
84,SGP,0,0,1,1,2024,France
84,SVK,0,0,1,1,2024,France
84,ZAM,0,0,1,1,2024,France
