Rank,NOC,Gold,Silver,Bronze,Total,Year,host_NOC
1,USA,11,7,2,20,1896,GRE
2,GRE,10,18,19,47,1896,GRE
3,GER,6,5,2,13,1896,GRE
4,FRA,5,4,2,11,1896,GRE
5,GBR,2,3,2,7,1896,GRE
6,HUN,2,1,3,6,1896,GRE
7,AUT,2,1,2,5,1896,GRE
8,AUS,2,0,0,2,1896,GRE
9,DEN,1,2,3,6,1896,GRE
10,SUI,1,2,0,3,1896,GRE
11,Mixed team,1,0,1,2,1896,GRE
1,FRA,27,39,37,103,1900,FRA
2,USA,19,14,15,48,1900,FRA
3,GBR,15,7,9,31,1900,FRA
4,Mixed team,8,5,6,19,1900,FRA
5,BEL,6,7,4,17,1900,FRA
6,SUI,6,2,1,9,1900,FRA
7,GER,4,3,2,9,1900,FRA
8,ITA,3,2,0,5,1900,FRA
9,AUS,2,0,3,5,1900,FRA
10,DEN,1,3,2,6,1900,FRA
11,HUN,1,2,2,5,1900,FRA
12,CUB,1,1,0,2,1900,FRA
13,CAN,1,0,1,2,1900,FRA
14,ESP,1,0,0,1,1900,FRA
14,LUX,1,0,0,1,1900,FRA
16,AUT,0,3,3,6,1900,FRA
17,NOR,0,2,3,5,1900,FRA
17,NED,0,2,3,5,1900,FRA
19,IND,0,2,0,2,1900,FRA
20,BOH,0,1,1,2,1900,FRA
21,SWE,0,0,1,1,1900,FRA
1,USA,76,78,77,231,1904,USA
2,GER,4,5,6,15,1904,USA
3,CAN,4,1,1,6,1904,USA
4,CUB,3,0,0,3,1904,USA
5,HUN,2,1,1,4,1904,USA
5,Mixed team,2,1,1,4,1904,USA
7,NOR,2,0,0,2,1904,USA
8,AUT,1,1,1,3,1904,USA
9,GBR,1,1,0,2,1904,USA
10,SUI,1,0,2,3,1904,USA
11,GRE,1,0,1,2,1904,USA
12,AUS,0,3,1,4,1904,USA
13,FRA,0,1,0,1,1904,USA
1,GBR,56,51,39,146,1908,GBR
2,USA,23,12,12,47,1908,GBR
3,SWE,8,6,11,25,1908,GBR
4,FRA,5,5,9,19,1908,GBR
5,GER,3,5,5,13,1908,GBR
6,HUN,3,4,2,9,1908,GBR
7,CAN,3,3,10,16,1908,GBR
8,NOR,2,3,3,8,1908,GBR
9,ITA,2,2,0,4,1908,GBR
10,BEL,1,5,2,8,1908,GBR
11,AUS,1,2,2,5,1908,GBR
12,RUS,1,2,0,3,1908,GBR
13,FIN,1,1,3,5,1908,GBR
14,RSA,1,1,0,2,1908,GBR
15,GRE,0,3,1,4,1908,GBR
16,DEN,0,2,3,5,1908,GBR
17,BOH,0,0,2,2,1908,GBR
17,NED,0,0,2,2,1908,GBR
19,AUT,0,0,1,1,1908,GBR
1,USA,26,19,19,64,1912,SWE
2,SWE,23,25,17,65,1912,SWE
3,GBR,10,15,16,41,1912,SWE
4,FIN,9,8,9,26,1912,SWE
5,FRA,7,4,3,14,1912,SWE
6,GER,5,13,7,25,1912,SWE
7,RSA,4,2,0,6,1912,SWE
8,NOR,3,2,5,10,1912,SWE
9,CAN,3,2,3,8,1912,SWE
9,HUN,3,2,3,8,1912,SWE
11,ITA,3,1,2,6,1912,SWE
12,AUS,2,2,3,7,1912,SWE
13,BEL,2,1,3,6,1912,SWE
14,DEN,1,6,5,12,1912,SWE
15,GRE,1,0,1,2,1912,SWE
16,RUS,0,2,3,5,1912,SWE
17,AUT,0,2,2,4,1912,SWE
18,NED,0,0,3,3,1912,SWE
1,USA,41,27,27,95,1920,BEL
2,SWE,19,20,25,64,1920,BEL
3,FIN,15,10,9,34,1920,BEL
4,GBR,14,15,13,42,1920,BEL
5,BEL,14,11,11,36,1920,BEL
6,NOR,13,9,9,31,1920,BEL
7,ITA,13,5,5,23,1920,BEL
8,FRA,9,19,13,41,1920,BEL
9,NED,4,2,5,11,1920,BEL
10,DEN,3,9,1,13,1920,BEL
11,RSA,3,4,3,10,1920,BEL
12,CAN,3,3,3,9,1920,BEL
13,SUI,2,2,7,11,1920,BEL
14,EST,1,2,0,3,1920,BEL
15,BRA,1,1,1,3,1920,BEL
16,AUS,0,2,1,3,1920,BEL
17,JPN,0,2,0,2,1920,BEL
17,ESP,0,2,0,2,1920,BEL
19,GRE,0,1,0,1,1920,BEL
19,LUX,0,1,0,1,1920,BEL
21,CZE,0,0,2,2,1920,BEL
22,NZL,0,0,1,1,1920,BEL
1,USA,45,27,27,99,1924,FRA
2,FIN,14,13,10,37,1924,FRA
3,FRA,13,15,10,38,1924,FRA
4,GBR,9,13,12,34,1924,FRA
5,ITA,8,3,5,16,1924,FRA
6,SUI,7,8,10,25,1924,FRA
7,NOR,5,2,3,10,1924,FRA
8,SWE,4,13,12,29,1924,FRA
9,NED,4,1,5,10,1924,FRA
10,BEL,3,7,3,13,1924,FRA
11,AUS,3,1,2,6,1924,FRA
12,DEN,2,5,2,9,1924,FRA
13,HUN,2,3,4,9,1924,FRA
14,YUG,2,0,0,2,1924,FRA
15,CZE,1,4,5,10,1924,FRA
16,ARG,1,3,2,6,1924,FRA
17,EST,1,1,4,6,1924,FRA
18,RSA,1,1,1,3,1924,FRA
19,URU,1,0,0,1,1924,FRA
20,AUT,0,3,1,4,1924,FRA
20,CAN,0,3,1,4,1924,FRA
22,POL,0,1,1,2,1924,FRA
23,HAI,0,0,1,1,1924,FRA
23,JPN,0,0,1,1,1924,FRA
23,NZL,0,0,1,1,1924,FRA
23,POR,0,0,1,1,1924,FRA
23,ROU,0,0,1,1,1924,FRA
1,USA,22,18,16,56,1928,NED
2,GER,10,7,14,31,1928,NED
3,FIN,8,8,9,25,1928,NED
4,SWE,7,6,12,25,1928,NED
5,ITA,7,5,7,19,1928,NED
6,SUI,7,4,4,15,1928,NED
7,FRA,6,10,5,21,1928,NED
8,NED,6,9,4,19,1928,NED
9,HUN,4,5,0,9,1928,NED
10,CAN,4,4,7,15,1928,NED
11,GBR,3,10,7,20,1928,NED
12,ARG,3,3,1,7,1928,NED
13,DEN,3,1,2,6,1928,NED
14,CZE,2,5,2,9,1928,NED
15,JPN,2,2,1,5,1928,NED
16,EST,2,1,2,5,1928,NED
17,EGY,2,1,1,4,1928,NED
18,AUT,2,0,1,3,1928,NED
19,AUS,1,2,1,4,1928,NED
19,NOR,1,2,1,4,1928,NED
21,POL,1,1,3,5,1928,NED
21,YUG,1,1,3,5,1928,NED
23,RSA,1,0,2,3,1928,NED
24,IND,1,0,0,1,1928,NED
24,IRL,1,0,0,1,1928,NED
24,NZL,1,0,0,1,1928,NED
24,ESP,1,0,0,1,1928,NED
24,URU,1,0,0,1,1928,NED
29,BEL,0,1,2,3,1928,NED
30,CHI,0,1,0,1,1928,NED
30,HAI,0,1,0,1,1928,NED
32,PHI,0,0,1,1,1928,NED
32,POR,0,0,1,1,1928,NED
1,USA,44,36,30,110,1932,USA
2,ITA,12,12,12,36,1932,USA
3,FRA,11,5,4,20,1932,USA
4,SWE,10,5,9,24,1932,USA
5,JPN,7,7,4,18,1932,USA
6,HUN,6,5,5,16,1932,USA
7,GER,5,12,7,24,1932,USA
8,FIN,5,8,12,25,1932,USA
9,GBR,5,7,5,17,1932,USA
10,POL,3,2,4,9,1932,USA
11,AUS,3,1,1,5,1932,USA
12,AFG,3,1,0,4,1932,USA
13,CAN,2,5,9,16,1932,USA
14,NED,2,5,1,8,1932,USA
15,RSA,2,0,3,5,1932,USA
16,IRL,2,0,0,2,1932,USA
17,CZE,1,3,2,6,1932,USA
18,AUS,1,1,3,5,1932,USA
19,IND,1,0,0,1,1932,USA
20,DEN,0,5,3,8,1932,USA
21,MEX,0,2,0,2,1932,USA
22,LAT,0,1,0,1,1932,USA
22,NZL,0,1,0,1,1932,USA
22,SUI ,0,1,0,1,1932,USA
25,PHI,0,0,3,3,1932,USA
26,BEL,0,0,1,1,1932,USA
26,ESP,0,0,1,1,1932,USA
26,URU,0,0,1,1,1932,USA
1,GER,38,31,32,101,1936,GER
2,USA,24,21,12,57,1936,GER
3,HUN,10,1,5,16,1936,GER
4,ITA,9,13,5,27,1936,GER
5,FIN,8,6,6,20,1936,GER
6,FRA,7,6,6,19,1936,GER
7,SWE,6,5,10,21,1936,GER
8,JPN,6,4,10,20,1936,GER
9,NED,6,4,7,17,1936,GER
10,AUT,5,7,5,17,1936,GER
11,SUI,4,9,5,18,1936,GER
12,GBR,4,7,3,14,1936,GER
13,CZE,3,5,1,9,1936,GER
14,ARG,2,2,3,7,1936,GER
14,EST,2,2,3,7,1936,GER
16,EGY,2,1,2,5,1936,GER
17,CAN,1,3,5,9,1936,GER
18,NOR,1,3,2,6,1936,GER
19,TUR,1,0,1,2,1936,GER
20,IND,1,0,0,1,1936,GER
20,NZL,1,0,0,1,1936,GER
22,POL,0,4,5,9,1936,GER
23,DEN,0,2,3,5,1936,GER
24,LAT,0,1,1,2,1936,GER
25,ROU,0,1,0,1,1936,GER
25,RSA,0,1,0,1,1936,GER
25,YUG,0,1,0,1,1936,GER
28,BEL,0,0,3,3,1936,GER
28,MEX,0,0,3,3,1936,GER
30,AUS,0,0,1,1,1936,GER
30,PHI,0,0,1,1,1936,GER
30,POR,0,0,1,1,1936,GER
1,USA,38,27,19,84,1948,GBR
2,SWE,16,11,17,44,1948,GBR
3,FRA,10,6,13,29,1948,GBR
4,HUN,10,5,12,27,1948,GBR
5,ITA,8,11,8,27,1948,GBR
6,FIN,8,7,5,20,1948,GBR
7,TUR,6,4,2,12,1948,GBR
8,CZE,6,2,3,11,1948,GBR
9,SUI,5,10,5,20,1948,GBR
10,DEN,5,7,8,20,1948,GBR
11,NED,5,2,9,16,1948,GBR
12,GBR,3,14,6,23,1948,GBR
13,ARG,3,3,1,7,1948,GBR
14,AUS,2,6,5,13,1948,GBR
15,BEL,2,2,3,7,1948,GBR
16,EGY,2,2,1,5,1948,GBR
17,MEX,2,1,2,5,1948,GBR
18,RSA,2,1,1,4,1948,GBR
19,NOR,1,3,3,7,1948,GBR
20,JAM,1,2,0,3,1948,GBR
21,AUT,1,0,3,4,1948,GBR
22,IND,1,0,0,1,1948,GBR
22,PER,1,0,0,1,1948,GBR
24,YUG,0,2,0,2,1948,GBR
25,CAN,0,1,2,3,1948,GBR
26,POR,0,1,1,2,1948,GBR
26,URU,0,1,1,2,1948,GBR
28,Ceylon,0,1,0,1,1948,GBR
28,CUB,0,1,0,1,1948,GBR
28,ESP,0,1,0,1,1948,GBR
28,TTO,0,1,0,1,1948,GBR
32,PAN,0,0,2,2,1948,GBR
32,KOR,0,0,2,2,1948,GBR
34,BRA,0,0,1,1,1948,GBR
34,IRI,0,0,1,1,1948,GBR
34,POL,0,0,1,1,1948,GBR
34,PUR,0,0,1,1,1948,GBR
1,USA,40,19,17,76,1952,FIN
2,URS,22,30,19,71,1952,FIN
3,HUN,16,10,16,42,1952,FIN
4,SWE,12,13,10,35,1952,FIN
5,ITA,8,9,4,21,1952,FIN
6,CZE,7,3,3,13,1952,FIN
7,FRA,6,6,6,18,1952,FIN
8,FIN,6,3,13,22,1952,FIN
9,AUS,6,2,3,11,1952,FIN
10,NOR,3,2,0,5,1952,FIN
11,SUI,2,6,6,14,1952,FIN
12,RSA,2,4,4,10,1952,FIN
13,JAM,2,3,0,5,1952,FIN
14,BEL,2,2,0,4,1952,FIN
15,DEN,2,1,3,6,1952,FIN
16,TUR,2,0,1,3,1952,FIN
17,JPN,1,6,2,9,1952,FIN
18,GBR,1,2,8,11,1952,FIN
19,ARG,1,2,2,5,1952,FIN
20,POL,1,2,1,4,1952,FIN
21,CAN,1,2,0,3,1952,FIN
21,YUG,1,2,0,3,1952,FIN
23,ROU,1,1,2,4,1952,FIN
24,BRA,1,0,2,3,1952,FIN
24,NZL,1,0,2,3,1952,FIN
26,IND,1,0,1,2,1952,FIN
27,LUX,1,0,0,1,1952,FIN
28,GER,0,7,17,24,1952,FIN
29,NED,0,5,0,5,1952,FIN
30,IRI,0,3,4,7,1952,FIN
31,CHI,0,2,0,2,1952,FIN
32,AUT,0,1,1,2,1952,FIN
32,LBN,0,1,1,2,1952,FIN
34,IRL,0,1,0,1,1952,FIN
34,MEX,0,1,0,1,1952,FIN
34,ESP,0,1,0,1,1952,FIN
37,KOR,0,0,2,2,1952,FIN
37,TTO,0,0,2,2,1952,FIN
37,URU,0,0,2,2,1952,FIN
40,BUL,0,0,1,1,1952,FIN
40,EGY,0,0,1,1,1952,FIN
40,POR,0,0,1,1,1952,FIN
40,VEN,0,0,1,1,1952,FIN
1,URS,37,29,32,98,1956,AUS
2,USA,32,25,17,74,1956,AUS
3,AUS,13,8,14,35,1956,AUS
4,HUN,9,10,7,26,1956,AUS
5,ITA,8,8,9,25,1956,AUS
6,SWE,8,5,6,19,1956,AUS
7,EUN,6,13,7,26,1956,AUS
8,GBR,6,7,11,24,1956,AUS
9,ROU,5,3,5,13,1956,AUS
10,JPN,4,10,5,19,1956,AUS
11,FRA,4,4,6,14,1956,AUS
12,TUR,3,2,2,7,1956,AUS
13,FIN,3,1,11,15,1956,AUS
14,IRI,2,2,1,5,1956,AUS
15,CAN,2,1,3,6,1956,AUS
16,NZL,2,0,0,2,1956,AUS
17,POL,1,4,4,9,1956,AUS
18,CZE,1,4,1,6,1956,AUS
19,BUL,1,3,1,5,1956,AUS
20,DEN,1,2,1,4,1956,AUS
21,IRL,1,1,3,5,1956,AUS
22,NOR,1,0,2,3,1956,AUS
23,MEX,1,0,1,2,1956,AUS
24,BRA,1,0,0,1,1956,AUS
24,IND,1,0,0,1,1956,AUS
26,YUG,0,3,0,3,1956,AUS
27,CHI,0,2,2,4,1956,AUS
28,BEL,0,2,0,2,1956,AUS
29,ARG,0,1,1,2,1956,AUS
29,KOR,0,1,1,2,1956,AUS
31,ISL,0,1,0,1,1956,AUS
31,PAK,0,1,0,1,1956,AUS
33,RSA,0,0,4,4,1956,AUS
34,AUT,0,0,2,2,1956,AUS
35,BAH,0,0,1,1,1956,AUS
35,GRE,0,0,1,1,1956,AUS
35,SUI,0,0,1,1,1956,AUS
35,URU,0,0,1,1,1956,AUS
1,URS,43,29,31,103,1960,ITA
2,USA,34,21,16,71,1960,ITA
3,ITA,13,10,13,36,1960,ITA
4,EUN,12,19,11,42,1960,ITA
5,AUS,8,8,6,22,1960,ITA
6,TUR,7,2,0,9,1960,ITA
7,HUN,6,8,7,21,1960,ITA
8,JPN,4,7,7,18,1960,ITA
9,POL,4,6,11,21,1960,ITA
10,CZE,3,2,3,8,1960,ITA
11,ROU,3,1,6,10,1960,ITA
12,GBR,2,6,12,20,1960,ITA
13,DEN,2,3,1,6,1960,ITA
14,NZL,2,0,1,3,1960,ITA
15,BUL,1,3,3,7,1960,ITA
16,SWE,1,2,3,6,1960,ITA
17,FIN,1,1,3,5,1960,ITA
18,AUS,1,1,0,2,1960,ITA
18,YUG,1,1,0,2,1960,ITA
20,PAK,1,0,1,2,1960,ITA
21,ETH,1,0,0,1,1960,ITA
21,GRE,1,0,0,1,1960,ITA
21,NOR,1,0,0,1,1960,ITA
24,SUI,0,3,3,6,1960,ITA
25,FRA,0,2,3,5,1960,ITA
26,BEL,0,2,2,4,1960,ITA
27,IRI,0,1,3,4,1960,ITA
28,NED,0,1,2,3,1960,ITA
28,RSA,0,1,2,3,1960,ITA
30,AFG,0,1,1,2,1960,ITA
30,EGY,0,1,1,2,1960,ITA
32,CAN,0,1,0,1,1960,ITA
32,USA,0,1,0,1,1960,ITA
32,GHA,0,1,0,1,1960,ITA
32,IND,0,1,0,1,1960,ITA
32,MAR,0,1,0,1,1960,ITA
32,POR,0,1,0,1,1960,ITA
32,SGP,0,1,0,1,1960,ITA
39,BRA,0,0,2,2,1960,ITA
39,WIF,0,0,2,2,1960,ITA
41,Iraq ,0,0,1,1,1960,ITA
41,MEX,0,0,1,1,1960,ITA
41,ESP,0,0,1,1,1960,ITA
41,VEN,0,0,1,1,1960,ITA
1,USA,36,26,28,90,1964,JPN
2,URS,30,31,35,96,1964,JPN
3,JPN,16,5,8,29,1964,JPN
4,EUN,10,22,18,50,1964,JPN
5,ITA,10,10,7,27,1964,JPN
6,HUN,10,7,5,22,1964,JPN
7,POL,7,6,10,23,1964,JPN
8,AUS,6,2,10,18,1964,JPN
9,CZE,5,6,3,14,1964,JPN
10,GBR,4,12,2,18,1964,JPN
11,BUL,3,5,2,10,1964,JPN
12,FIN,3,0,2,5,1964,JPN
12,NZL,3,0,2,5,1964,JPN
14,ROU,2,4,6,12,1964,JPN
15,NED,2,4,4,10,1964,JPN
16,TUR,2,3,1,6,1964,JPN
17,SWE,2,2,4,8,1964,JPN
18,DEN,2,1,3,6,1964,JPN
19,YUG,2,1,2,5,1964,JPN
20,BEL,2,0,1,3,1964,JPN
21,FRA,1,8,6,15,1964,JPN
22,CAN,1,2,1,4,1964,JPN
22,SUI,1,2,1,4,1964,JPN
24,BAH,1,0,0,1,1964,JPN
24,ETH,1,0,0,1,1964,JPN
24,IND,1,0,0,1,1964,JPN
27,KOR,0,2,1,3,1964,JPN
28,TTO,0,1,2,3,1964,JPN
29,TUN,0,1,1,2,1964,JPN
30,ARG,0,1,0,1,1964,JPN
30,CUB,0,1,0,1,1964,JPN
30,PAK,0,1,0,1,1964,JPN
30,PHI,0,1,0,1,1964,JPN
34,IRI,0,0,2,2,1964,JPN
35,BRA,0,0,1,1,1964,JPN
35,GHA,0,0,1,1,1964,JPN
35,IRL,0,0,1,1,1964,JPN
35,KEN,0,0,1,1,1964,JPN
35,MEX,0,0,1,1,1964,JPN
35,NGR,0,0,1,1,1964,JPN
35,URU,0,0,1,1,1964,JPN
1,USA,45,28,34,107,1968,MEX
2,URS,29,32,30,91,1968,MEX
3,JPN,11,7,7,25,1968,MEX
4,HUN,10,10,12,32,1968,MEX
5,GDR,9,9,7,25,1968,MEX
6,FRA,7,3,5,15,1968,MEX
7,CZE,7,2,4,13,1968,MEX
8,FRG,5,11,10,26,1968,MEX
9,AUS,5,7,5,17,1968,MEX
10,GBR,5,5,3,13,1968,MEX
11,POL,5,2,11,18,1968,MEX
12,ROU,4,6,5,15,1968,MEX
13,ITA,3,4,9,16,1968,MEX
14,KEN,3,4,2,9,1968,MEX
15,MEX,3,3,3,9,1968,MEX
16,YUG,3,3,2,8,1968,MEX
17,NED,3,3,1,7,1968,MEX
18,BUL,2,4,3,9,1968,MEX
19,IRI,2,1,2,5,1968,MEX
20,SWE,2,1,1,4,1968,MEX
21,TUR,2,0,0,2,1968,MEX
22,DEN,1,4,3,8,1968,MEX
23,CAN,1,3,1,5,1968,MEX
24,FIN,1,2,1,4,1968,MEX
25,ETH,1,1,0,2,1968,MEX
25,NOR,1,1,0,2,1968,MEX
27,NZL,1,0,2,3,1968,MEX
28,TUN,1,0,1,2,1968,MEX
29,PAK,1,0,0,1,1968,MEX
29,VEN,1,0,0,1,1968,MEX
31,CUB,0,4,0,4,1968,MEX
32,AUT,0,2,2,4,1968,MEX
33,SUI,0,1,4,5,1968,MEX
34,MGL,0,1,3,4,1968,MEX
35,BRA,0,1,2,3,1968,MEX
36,BEL,0,1,1,2,1968,MEX
36,KOR,0,1,1,2,1968,MEX
36,UGA,0,1,1,2,1968,MEX
39,CMR,0,1,0,1,1968,MEX
39,JAM,0,1,0,1,1968,MEX
41,ARG,0,0,2,2,1968,MEX
42,GRE,0,0,1,1,1968,MEX
42,IND,0,0,1,1,1968,MEX
42,Taiwan,0,0,1,1,1968,MEX
1,URS,50,27,22,99,1972,GER
2,USA,33,31,30,94,1972,GER
3,GDR,20,23,23,66,1972,GER
4,FRG,13,11,16,40,1972,GER
5,JPN,13,8,8,29,1972,GER
6,AUS,8,7,2,17,1972,GER
7,POL,7,5,9,21,1972,GER
8,HUN,6,13,16,35,1972,GER
9,BUL,6,10,5,21,1972,GER
10,ITA,5,3,10,18,1972,GER
11,SWE,4,6,6,16,1972,GER
12,GBR,4,5,9,18,1972,GER
13,ROU,3,6,7,16,1972,GER
14,CUB,3,1,4,8,1972,GER
14,FIN,3,1,4,8,1972,GER
16,NED,3,1,1,5,1972,GER
17,FRA,2,4,7,13,1972,GER
18,CZE,2,4,2,8,1972,GER
19,KEN,2,3,4,9,1972,GER
20,YUG,2,1,2,5,1972,GER
21,NOR,2,1,1,4,1972,GER
22,PRK,1,1,3,5,1972,GER
23,NZL,1,1,1,3,1972,GER
24,UGA,1,1,0,2,1972,GER
25,DEN,1,0,0,1,1972,GER
26,SUI,0,3,0,3,1972,GER
27,CAN,0,2,3,5,1972,GER
28,IRI,0,2,1,3,1972,GER
29,BEL,0,2,0,2,1972,GER
29,GRE,0,2,0,2,1972,GER
31,AUT,0,1,2,3,1972,GER
31,COL,0,1,2,3,1972,GER
33,ARG,0,1,0,1,1972,GER
33,LBN,0,1,0,1,1972,GER
33,MEX,0,1,0,1,1972,GER
33,MGL,0,1,0,1,1972,GER
33,PAK,0,1,0,1,1972,GER
33,KOR,0,1,0,1,1972,GER
33,TUN,0,1,0,1,1972,GER
33,TUR,0,1,0,1,1972,GER
41,BRA,0,0,2,2,1972,GER
41,ETH,0,0,2,2,1972,GER
43,GHA,0,0,1,1,1972,GER
43,IND,0,0,1,1,1972,GER
43,JAM,0,0,1,1,1972,GER
43,NIG,0,0,1,1,1972,GER
43,NGR,0,0,1,1,1972,GER
43,ESP,0,0,1,1,1972,GER
1,URS,49,41,35,125,1976,CAN
2,GDR,40,25,25,90,1976,CAN
3,USA,34,35,25,94,1976,CAN
4,FRG,10,12,17,39,1976,CAN
5,JPN,9,6,10,25,1976,CAN
6,POL,7,6,13,26,1976,CAN
7,BUL,6,9,7,22,1976,CAN
8,CUB,6,4,3,13,1976,CAN
9,ROU,4,9,14,27,1976,CAN
10,HUN,4,5,13,22,1976,CAN
11,FIN,4,2,0,6,1976,CAN
12,SWE,4,1,0,5,1976,CAN
13,GBR,3,5,5,13,1976,CAN
14,ITA,2,7,4,13,1976,CAN
15,FRA,2,3,4,9,1976,CAN
16,YUG,2,3,3,8,1976,CAN
17,CZE,2,2,4,8,1976,CAN
18,NZL,2,1,1,4,1976,CAN
19,KOR,1,1,4,6,1976,CAN
20,SUI,1,1,2,4,1976,CAN
21,JAM,1,1,0,2,1976,CAN
21,PRK,1,1,0,2,1976,CAN
21,NOR,1,1,0,2,1976,CAN
24,DEN,1,0,2,3,1976,CAN
25,MEX,1,0,1,2,1976,CAN
26,TTO,1,0,0,1,1976,CAN
27,CAN,0,5,6,11,1976,CAN
28,BEL,0,3,3,6,1976,CAN
29,NED,0,2,3,5,1976,CAN
30,POR,0,2,0,2,1976,CAN
30,ESP,0,2,0,2,1976,CAN
32,AUS,0,1,4,5,1976,CAN
33,IRI,0,1,1,2,1976,CAN
34,MGL,0,1,0,1,1976,CAN
34,VEN,0,1,0,1,1976,CAN
36,BRA,0,0,2,2,1976,CAN
37,AUT,0,0,1,1,1976,CAN
37,BER,0,0,1,1,1976,CAN
37,PAK,0,0,1,1,1976,CAN
37,PUR,0,0,1,1,1976,CAN
37,THA,0,0,1,1,1976,CAN
1,URS,80,69,46,195,1980,URS
2,GDR,47,37,42,126,1980,URS
3,BUL,8,16,17,41,1980,URS
4,CUB,8,7,5,20,1980,URS
5,ITA,8,3,4,15,1980,URS
6,HUN,7,10,15,32,1980,URS
7,ROU,6,6,13,25,1980,URS
8,FRA,6,5,3,14,1980,URS
9,GBR,5,7,9,21,1980,URS
10,POL,3,14,15,32,1980,URS
11,SWE,3,3,6,12,1980,URS
12,FIN,3,1,4,8,1980,URS
13,CZE,2,3,9,14,1980,URS
14,YUG,2,3,4,9,1980,URS
15,AUS,2,2,5,9,1980,URS
16,DEN,2,1,2,5,1980,URS
17,BRA,2,0,2,4,1980,URS
17,ETH,2,0,2,4,1980,URS
19,SUI,2,0,0,2,1980,URS
20,ESP,1,3,2,6,1980,URS
21,AUT,1,2,1,4,1980,URS
22,GRE,1,0,2,3,1980,URS
23,BEL,1,0,0,1,1980,URS
23,IND,1,0,0,1,1980,URS
23,ZIM,1,0,0,1,1980,URS
26,PRK,0,3,2,5,1980,URS
27,MGL,0,2,2,4,1980,URS
28,TAN,0,2,0,2,1980,URS
29,MEX,0,1,3,4,1980,URS
30,NED,0,1,2,3,1980,URS
31,IRL,0,1,1,2,1980,URS
32,UGA,0,1,0,1,1980,URS
32,VEN,0,1,0,1,1980,URS
34,JAM,0,0,3,3,1980,URS
35,GUY,0,0,1,1,1980,URS
35,LBN,0,0,1,1,1980,URS
1,USA,83,61,30,174,1984,USA
2,ROU,20,16,17,53,1984,USA
3,FRG,17,19,23,59,1984,USA
4,CHN,15,8,9,32,1984,USA
5,ITA,14,6,12,32,1984,USA
6,CAN,10,18,16,44,1984,USA
7,JPN,10,8,14,32,1984,USA
8,NZL,8,1,2,11,1984,USA
9,YUG,7,4,7,18,1984,USA
10,KOR,6,6,7,19,1984,USA
11,GBR,5,11,21,37,1984,USA
12,FRA,5,7,16,28,1984,USA
13,NED,5,2,6,13,1984,USA
14,AUS,4,8,12,24,1984,USA
15,FIN,4,2,6,12,1984,USA
16,SWE,2,11,6,19,1984,USA
17,MEX,2,3,1,6,1984,USA
18,MAR,2,0,0,2,1984,USA
19,BRA,1,5,2,8,1984,USA
20,ESP,1,2,2,5,1984,USA
21,BEL,1,1,2,4,1984,USA
22,AUT,1,1,1,3,1984,USA
23,KEN,1,0,2,3,1984,USA
23,POR,1,0,2,3,1984,USA
25,PAK,1,0,0,1,1984,USA
26,SUI,0,4,4,8,1984,USA
27,DEN,0,3,3,6,1984,USA
28,JAM,0,1,2,3,1984,USA
28,NOR,0,1,2,3,1984,USA
30,GRE,0,1,1,2,1984,USA
30,NGR,0,1,1,2,1984,USA
30,PUR,0,1,1,2,1984,USA
33,COL,0,1,0,1,1984,USA
33,EGY,0,1,0,1,1984,USA
33,IRL,0,1,0,1,1984,USA
33,CIV,0,1,0,1,1984,USA
33,PER,0,1,0,1,1984,USA
33,SYR,0,1,0,1,1984,USA
33,THA,0,1,0,1,1984,USA
40,TUR,0,0,3,3,1984,USA
40,VEN,0,0,3,3,1984,USA
42,ALG,0,0,2,2,1984,USA
43,CMR,0,0,1,1,1984,USA
43,TPE,0,0,1,1,1984,USA
43,DOM,0,0,1,1,1984,USA
43,ISL,0,0,1,1,1984,USA
43,ZAM,0,0,1,1,1984,USA
1,URS,55,31,46,132,1988,KOR
2,GDR,37,35,30,102,1988,KOR
3,USA,36,31,27,94,1988,KOR
4,KOR,12,10,11,33,1988,KOR
5,FRG,11,14,15,40,1988,KOR
6,HUN,11,6,6,23,1988,KOR
7,BUL,10,12,13,35,1988,KOR
8,ROU,7,11,6,24,1988,KOR
9,FRA,6,4,6,16,1988,KOR
10,ITA,6,4,4,14,1988,KOR
11,CHN,5,11,12,28,1988,KOR
12,GBR,5,10,9,24,1988,KOR
13,KEN,5,2,2,9,1988,KOR
14,JPN,4,3,7,14,1988,KOR
15,AUS,3,6,5,14,1988,KOR
16,YUG,3,4,5,12,1988,KOR
17,CZE,3,3,2,8,1988,KOR
18,NZL,3,2,8,13,1988,KOR
19,CAN,3,2,5,10,1988,KOR
20,POL,2,5,9,16,1988,KOR
21,NOR,2,3,0,5,1988,KOR
22,NED,2,2,5,9,1988,KOR
23,DEN,2,1,1,4,1988,KOR
24,BRA,1,2,3,6,1988,KOR
25,FIN,1,1,2,4,1988,KOR
25,ESP,1,1,2,4,1988,KOR
27,TUR,1,1,0,2,1988,KOR
28,MAR,1,0,2,3,1988,KOR
29,AUT,1,0,0,1,1988,KOR
29,POR,1,0,0,1,1988,KOR
29,SUR,1,0,0,1,1988,KOR
32,SWE,0,4,7,11,1988,KOR
33,SUI,0,2,2,4,1988,KOR
34,JAM,0,2,0,2,1988,KOR
35,ARG,0,1,1,2,1988,KOR
36,CHI,0,1,0,1,1988,KOR
36,CRC,0,1,0,1,1988,KOR
36,INA,0,1,0,1,1988,KOR
36,IRI,0,1,0,1,1988,KOR
36,AHO,0,1,0,1,1988,KOR
36,PER,0,1,0,1,1988,KOR
36,SEN,0,1,0,1,1988,KOR
36,ISV,0,1,0,1,1988,KOR
44,BEL,0,0,2,2,1988,KOR
44,MEX,0,0,2,2,1988,KOR
46,COL,0,0,1,1,1988,KOR
46,DJI,0,0,1,1,1988,KOR
46,GRE,0,0,1,1,1988,KOR
46,MGL,0,0,1,1,1988,KOR
46,PAK,0,0,1,1,1988,KOR
46,PHI,0,0,1,1,1988,KOR
46,THA,0,0,1,1,1988,KOR
1,EUN,45,38,29,112,1992,ESP
2,USA,37,34,37,108,1992,ESP
3,GER,33,21,28,82,1992,ESP
4,CHN,16,22,16,54,1992,ESP
5,CUB,14,6,11,31,1992,ESP
6,ESP,13,7,2,22,1992,ESP
7,KOR,12,5,12,29,1992,ESP
8,HUN,11,12,7,30,1992,ESP
9,FRA,8,5,16,29,1992,ESP
10,AUS,7,9,11,27,1992,ESP
11,CAN,7,4,7,18,1992,ESP
12,ITA,6,5,8,19,1992,ESP
13,GBR,5,3,12,20,1992,ESP
14,ROU,4,6,8,18,1992,ESP
15,CZE,4,2,1,7,1992,ESP
16,PRK,4,0,5,9,1992,ESP
17,JPN,3,8,11,22,1992,ESP
18,BUL,3,7,6,16,1992,ESP
19,POL,3,6,10,19,1992,ESP
20,NED,2,6,7,15,1992,ESP
21,KEN,2,4,2,8,1992,ESP
22,NOR,2,4,1,7,1992,ESP
23,TUR,2,2,2,6,1992,ESP
24,INA,2,2,1,5,1992,ESP
25,BRA,2,1,0,3,1992,ESP
26,GRE,2,0,0,2,1992,ESP
27,SWE,1,7,4,12,1992,ESP
28,NZL,1,4,5,10,1992,ESP
29,FIN,1,2,2,5,1992,ESP
30,DEN,1,1,4,6,1992,ESP
31,MAR,1,1,1,3,1992,ESP
32,IRL,1,1,0,2,1992,ESP
33,ETH,1,0,2,3,1992,ESP
34,ALG,1,0,1,2,1992,ESP
34,EST,1,0,1,2,1992,ESP
34,LTU,1,0,1,2,1992,ESP
37,SUI,1,0,0,1,1992,ESP
38,JAM,0,3,1,4,1992,ESP
38,NGR,0,3,1,4,1992,ESP
40,LAT,0,2,1,3,1992,ESP
41,AUT,0,2,0,2,1992,ESP
41,NAM,0,2,0,2,1992,ESP
41,RSA,0,2,0,2,1992,ESP
44,BEL,0,1,2,3,1992,ESP
44,CRO,0,1,2,3,1992,ESP
44,Independent Olympic Participants,0,1,2,3,1992,ESP
44,IRI,0,1,2,3,1992,ESP
48,ISR,0,1,1,2,1992,ESP
49,TPE,0,1,0,1,1992,ESP
49,MEX,0,1,0,1,1992,ESP
49,PER,0,1,0,1,1992,ESP
52,MGL,0,0,2,2,1992,ESP
52,SLO,0,0,2,2,1992,ESP
54,ARG,0,0,1,1,1992,ESP
54,BAH,0,0,1,1,1992,ESP
54,COL,0,0,1,1,1992,ESP
54,GHA,0,0,1,1,1992,ESP
54,MAS,0,0,1,1,1992,ESP
54,PAK,0,0,1,1,1992,ESP
54,PHI,0,0,1,1,1992,ESP
54,PUR,0,0,1,1,1992,ESP
54,QAT,0,0,1,1,1992,ESP
54,SUR,0,0,1,1,1992,ESP
54,THA,0,0,1,1,1992,ESP
1,USA,44,32,25,101,1996,USA
2,RUS,26,21,16,63,1996,USA
3,GER,20,18,27,65,1996,USA
4,CHN,16,22,12,50,1996,USA
5,FRA,15,7,15,37,1996,USA
6,ITA,13,10,12,35,1996,USA
7,AUS,9,9,23,41,1996,USA
8,CUB,9,8,8,25,1996,USA
9,UKR,9,2,12,23,1996,USA
10,KOR,7,15,5,27,1996,USA
11,POL,7,5,5,17,1996,USA
12,HUN,7,4,10,21,1996,USA
13,ESP,5,6,6,17,1996,USA
14,ROU,4,7,9,20,1996,USA
15,NED,4,5,10,19,1996,USA
16,GRE,4,4,0,8,1996,USA
17,CZE,4,3,4,11,1996,USA
18,SUI,4,3,0,7,1996,USA
19,DEN,4,1,1,6,1996,USA
19,TUR,4,1,1,6,1996,USA
21,CAN,3,11,8,22,1996,USA
22,BUL,3,7,5,15,1996,USA
23,JPN,3,6,5,14,1996,USA
24,KAZ,3,4,4,11,1996,USA
25,BRA,3,3,9,15,1996,USA
26,NZL,3,2,1,6,1996,USA
27,RSA,3,1,1,5,1996,USA
28,IRL,3,0,1,4,1996,USA
29,SWE,2,4,2,8,1996,USA
30,NOR,2,2,3,7,1996,USA
31,BEL,2,2,2,6,1996,USA
32,NGR,2,1,3,6,1996,USA
33,PRK,2,1,2,5,1996,USA
34,ALG,2,0,1,3,1996,USA
34,ETH,2,0,1,3,1996,USA
36,GBR,1,8,6,15,1996,USA
37,BLR,1,6,8,15,1996,USA
38,KEN,1,4,3,8,1996,USA
39,JAM,1,3,2,6,1996,USA
40,FIN,1,2,1,4,1996,USA
41,YUG,1,1,2,4,1996,USA
41,INA,1,1,2,4,1996,USA
43,IRI,1,1,1,3,1996,USA
43,SVK,1,1,1,3,1996,USA
45,ARM,1,1,0,2,1996,USA
45,CRO,1,1,0,2,1996,USA
47,POR,1,0,1,2,1996,USA
47,THA,1,0,1,2,1996,USA
49,BDI,1,0,0,1,1996,USA
49,CRC,1,0,0,1,1996,USA
49,ECU,1,0,0,1,1996,USA
49,HKG,1,0,0,1,1996,USA
49,SYR,1,0,0,1,1996,USA
54,ARG,0,2,1,3,1996,USA
55,NAM,0,2,0,2,1996,USA
55,SLO,0,2,0,2,1996,USA
57,AUT,0,1,2,3,1996,USA
58,MAS,0,1,1,2,1996,USA
58,MDA,0,1,1,2,1996,USA
58,UZB,0,1,1,2,1996,USA
61,AZE,0,1,0,1,1996,USA
61,BAH,0,1,0,1,1996,USA
61,TPE,0,1,0,1,1996,USA
61,LAT,0,1,0,1,1996,USA
61,PHI,0,1,0,1,1996,USA
61,TGA,0,1,0,1,1996,USA
61,ZAM,0,1,0,1,1996,USA
68,GEO,0,0,2,2,1996,USA
68,MAR,0,0,2,2,1996,USA
68,TTO,0,0,2,2,1996,USA
71,IND,0,0,1,1,1996,USA
71,ISR,0,0,1,1,1996,USA
71,LTU,0,0,1,1,1996,USA
71,MEX,0,0,1,1,1996,USA
71,MGL,0,0,1,1,1996,USA
71,MOZ,0,0,1,1,1996,USA
71,PUR,0,0,1,1,1996,USA
71,TUN,0,0,1,1,1996,USA
71,UGA,0,0,1,1,1996,USA
1,USA,37,24,32,93,2000,AUS
2,RUS,32,28,29,89,2000,AUS
3,CHN,28,16,14,58,2000,AUS
4,AUS,16,25,17,58,2000,AUS
5,GER,13,17,26,56,2000,AUS
6,FRA,13,14,11,38,2000,AUS
7,ITA,13,8,13,34,2000,AUS
8,NED,12,9,4,25,2000,AUS
9,CUB,11,11,7,29,2000,AUS
10,GBR,11,10,7,28,2000,AUS
11,ROU,11,6,9,26,2000,AUS
12,KOR,8,10,10,28,2000,AUS
13,HUN,8,6,3,17,2000,AUS
14,POL,6,5,3,14,2000,AUS
15,JPN,5,8,5,18,2000,AUS
16,BUL,5,6,2,13,2000,AUS
17,GRE,4,6,3,13,2000,AUS
18,SWE,4,5,3,12,2000,AUS
19,NOR,4,3,3,10,2000,AUS
20,ETH,4,1,3,8,2000,AUS
21,UKR,3,10,10,23,2000,AUS
22,KAZ,3,4,0,7,2000,AUS
23,BLR,3,3,11,17,2000,AUS
24,CAN,3,3,8,14,2000,AUS
25,ESP,3,3,5,11,2000,AUS
26,TUR,3,0,2,5,2000,AUS
27,IRI,3,0,1,4,2000,AUS
28,CZE,2,3,3,8,2000,AUS
29,KEN,2,3,2,7,2000,AUS
30,DEN,2,3,1,6,2000,AUS
31,FIN,2,1,1,4,2000,AUS
32,AUT,2,1,0,3,2000,AUS
33,LTU,2,0,3,5,2000,AUS
34,AZE,2,0,1,3,2000,AUS
34,BAH,2,0,1,3,2000,AUS
36,SLO,2,0,0,2,2000,AUS
37,SUI,1,6,2,9,2000,AUS
38,INA,1,3,2,6,2000,AUS
39,SVK,1,3,1,5,2000,AUS
40,MEX,1,2,3,6,2000,AUS
41,NGR,1,2,0,3,2000,AUS
42,ALG,1,1,3,5,2000,AUS
43,UZB,1,1,2,4,2000,AUS
44,YUG,1,1,1,3,2000,AUS
44,LAT,1,1,1,3,2000,AUS
46,NZL,1,0,3,4,2000,AUS
47,EST,1,0,2,3,2000,AUS
47,THA,1,0,2,3,2000,AUS
49,CRO,1,0,1,2,2000,AUS
50,CMR,1,0,0,1,2000,AUS
50,COL,1,0,0,1,2000,AUS
50,MOZ,1,0,0,1,2000,AUS
53,BRA,0,6,6,12,2000,AUS
54,JAM,0,6,3,9,2000,AUS
55,BEL,0,2,3,5,2000,AUS
55,RSA,0,2,3,5,2000,AUS
57,ARG,0,2,2,4,2000,AUS
58,TPE,0,1,4,5,2000,AUS
58,MAR,0,1,4,5,2000,AUS
60,PRK,0,1,3,4,2000,AUS
61,MDA,0,1,1,2,2000,AUS
61,KSA,0,1,1,2,2000,AUS
61,TTO,0,1,1,2,2000,AUS
64,IRL,0,1,0,1,2000,AUS
64,SRI,0,1,0,1,2000,AUS
64,URU,0,1,0,1,2000,AUS
64,VIE,0,1,0,1,2000,AUS
68,GEO,0,0,6,6,2000,AUS
69,CRC,0,0,2,2,2000,AUS
69,POR,0,0,2,2,2000,AUS
71,ARM,0,0,1,1,2000,AUS
71,BAR,0,0,1,1,2000,AUS
71,CHI,0,0,1,1,2000,AUS
71,ISL,0,0,1,1,2000,AUS
71,IND,0,0,1,1,2000,AUS
71,ISR,0,0,1,1,2000,AUS
71,KUW,0,0,1,1,2000,AUS
71,KGZ,0,0,1,1,2000,AUS
71,MKD,0,0,1,1,2000,AUS
71,QAT,0,0,1,1,2000,AUS
1,USA,36,39,26,101,2004,GRE
2,CHN,32,17,14,63,2004,GRE
3,RUS,28,26,36,90,2004,GRE
4,AUS,17,16,17,50,2004,GRE
5,JPN,16,9,12,37,2004,GRE
6,GER,13,16,20,49,2004,GRE
7,FRA,11,9,13,33,2004,GRE
8,ITA,10,11,11,32,2004,GRE
9,KOR,9,12,9,30,2004,GRE
10,GBR,9,9,12,30,2004,GRE
11,CUB,9,7,11,27,2004,GRE
12,HUN,8,6,3,17,2004,GRE
13,UKR,8,5,9,22,2004,GRE
14,ROU,8,5,6,19,2004,GRE
15,GRE,6,6,4,16,2004,GRE
16,BRA,5,2,3,10,2004,GRE
17,NOR,5,0,1,6,2004,GRE
18,NED,4,9,9,22,2004,GRE
19,SWE,4,2,1,7,2004,GRE
20,ESP,3,11,6,20,2004,GRE
21,CAN,3,6,3,12,2004,GRE
22,TUR,3,3,4,10,2004,GRE
23,POL,3,2,5,10,2004,GRE
24,NZL,3,2,0,5,2004,GRE
25,THA,3,1,4,8,2004,GRE
26,BLR,2,5,6,13,2004,GRE
27,AUT,2,4,1,7,2004,GRE
28,ETH,2,3,2,7,2004,GRE
29,IRI,2,2,2,6,2004,GRE
29,SVK,2,2,2,6,2004,GRE
31,TPE,2,2,1,5,2004,GRE
32,GEO,2,2,0,4,2004,GRE
33,BUL,2,1,9,12,2004,GRE
34,DEN,2,1,5,8,2004,GRE
35,JAM,2,1,2,5,2004,GRE
35,UZB,2,1,2,5,2004,GRE
37,MAR,2,1,0,3,2004,GRE
38,ARG,2,0,4,6,2004,GRE
39,CHI,2,0,1,3,2004,GRE
40,KAZ,1,4,3,8,2004,GRE
41,KEN,1,4,2,7,2004,GRE
42,CZE,1,3,5,9,2004,GRE
43,RSA,1,3,2,6,2004,GRE
44,CRO,1,2,2,5,2004,GRE
45,LTU,1,2,0,3,2004,GRE
46,EGY,1,1,3,5,2004,GRE
46,SUI,1,1,3,5,2004,GRE
48,INA,1,1,2,4,2004,GRE
49,ZIM,1,1,1,3,2004,GRE
50,AZE,1,0,4,5,2004,GRE
51,BEL,1,0,2,3,2004,GRE
52,BAH,1,0,1,2,2004,GRE
52,ISR,1,0,1,2,2004,GRE
54,CMR,1,0,0,1,2004,GRE
54,DOM,1,0,0,1,2004,GRE
54,UAE,1,0,0,1,2004,GRE
57,PRK,0,4,1,5,2004,GRE
58,LAT,0,4,0,4,2004,GRE
59,MEX,0,3,1,4,2004,GRE
60,POR,0,2,1,3,2004,GRE
61,FIN,0,2,0,2,2004,GRE
61,SCG,0,2,0,2,2004,GRE
63,SLO,0,1,3,4,2004,GRE
64,EST,0,1,2,3,2004,GRE
65,HKG,0,1,0,1,2004,GRE
65,IND,0,1,0,1,2004,GRE
65,PAR,0,1,0,1,2004,GRE
68,COL,0,0,2,2,2004,GRE
68,NGR,0,0,2,2,2004,GRE
68,VEN,0,0,2,2,2004,GRE
71,ERI,0,0,1,1,2004,GRE
71,MGL,0,0,1,1,2004,GRE
71,SYR,0,0,1,1,2004,GRE
71,TTO,0,0,1,1,2004,GRE
1,CHN,48,22,30,100,2008,CHN
2,USA,36,39,37,112,2008,CHN
3,RUS,24,13,23,60,2008,CHN
4,GBR,19,13,19,51,2008,CHN
5,GER,16,11,14,41,2008,CHN
6,AUS,14,15,17,46,2008,CHN
7,KOR,13,11,8,32,2008,CHN
8,JPN,9,8,8,25,2008,CHN
9,ITA,8,9,10,27,2008,CHN
10,FRA,7,16,20,43,2008,CHN
11,NED,7,5,4,16,2008,CHN
12,UKR,7,4,11,22,2008,CHN
13,KEN,6,4,6,16,2008,CHN
14,ESP,5,11,3,19,2008,CHN
15,JAM,5,4,2,11,2008,CHN
16,POL,4,5,2,11,2008,CHN
17,ETH,4,2,1,7,2008,CHN
18,ROU,4,1,4,9,2008,CHN
19,CUB,3,10,17,30,2008,CHN
20,CAN,3,9,8,20,2008,CHN
21,HUN,3,5,2,10,2008,CHN
22,NOR,3,5,1,9,2008,CHN
23,BRA,3,4,10,17,2008,CHN
24,BLR,3,4,7,14,2008,CHN
25,CZE,3,3,1,7,2008,CHN
26,SVK,3,3,0,6,2008,CHN
27,NZL,3,2,4,9,2008,CHN
28,GEO,3,2,2,7,2008,CHN
29,KAZ,2,3,4,9,2008,CHN
30,DEN,2,2,3,7,2008,CHN
31,PRK,2,2,2,6,2008,CHN
31,THA,2,2,2,6,2008,CHN
33,MGL,2,2,0,4,2008,CHN
34,SUI,2,1,4,7,2008,CHN
35,ARG,2,0,4,6,2008,CHN
36,MEX,2,0,2,4,2008,CHN
37,BEL,2,0,0,2,2008,CHN
38,ZIM,1,3,0,4,2008,CHN
39,SLO,1,2,2,5,2008,CHN
40,AZE,1,1,4,6,2008,CHN
40,INA,1,1,4,6,2008,CHN
42,BUL,1,1,3,5,2008,CHN
42,TUR,1,1,3,5,2008,CHN
44,TPE,1,1,2,4,2008,CHN
44,FIN,1,1,2,4,2008,CHN
46,LAT,1,1,1,3,2008,CHN
47,DOM,1,1,0,2,2008,CHN
47,EST,1,1,0,2,2008,CHN
47,POR,1,1,0,2,2008,CHN
47,TTO,1,1,0,2,2008,CHN
51,IND,1,0,2,3,2008,CHN
52,IRI,1,0,1,2,2008,CHN
53,CMR,1,0,0,1,2008,CHN
53,PAN,1,0,0,1,2008,CHN
53,TUN,1,0,0,1,2008,CHN
56,SWE,0,4,1,5,2008,CHN
57,LTU,0,3,2,5,2008,CHN
57,NGR,0,3,2,5,2008,CHN
59,CRO,0,2,3,5,2008,CHN
60,COL,0,2,1,3,2008,CHN
60,GRE,0,2,1,3,2008,CHN
62,ARM,0,1,4,5,2008,CHN
63,UZB,0,1,3,4,2008,CHN
64,AUT,0,1,2,3,2008,CHN
64,IRL,0,1,2,3,2008,CHN
64,KGZ,0,1,2,3,2008,CHN
64,SRB,0,1,2,3,2008,CHN
68,ALG,0,1,1,2,2008,CHN
68,BAH,0,1,1,2,2008,CHN
68,MAR,0,1,1,2,2008,CHN
68,TJK,0,1,1,2,2008,CHN
72,CHI,0,1,0,1,2008,CHN
72,ECU,0,1,0,1,2008,CHN
72,ISL,0,1,0,1,2008,CHN
72,MAS,0,1,0,1,2008,CHN
72,SAM,0,1,0,1,2008,CHN
72,SGP,0,1,0,1,2008,CHN
72,RSA,0,1,0,1,2008,CHN
72,SUD,0,1,0,1,2008,CHN
72,VIE,0,1,0,1,2008,CHN
81,EGY,0,0,2,2,2008,CHN
82,AFG,0,0,1,1,2008,CHN
82,ISR,0,0,1,1,2008,CHN
82,MRI,0,0,1,1,2008,CHN
82,MDA,0,0,1,1,2008,CHN
82,TOG,0,0,1,1,2008,CHN
82,VEN,0,0,1,1,2008,CHN
1,USA,48,26,30,104,2012,GBR
2,CHN,39,31,22,92,2012,GBR
3,GBR,29,18,18,65,2012,GBR
4,RUS,18,21,26,65,2012,GBR
5,KOR,13,9,9,31,2012,GBR
6,GER,11,20,13,44,2012,GBR
7,FRA,11,11,13,35,2012,GBR
8,AUS,8,15,12,35,2012,GBR
9,ITA,8,9,11,28,2012,GBR
10,HUN,8,4,6,18,2012,GBR
11,JPN,7,14,17,38,2012,GBR
12,IRI,7,5,1,13,2012,GBR
13,NED,6,6,8,20,2012,GBR
14,NZL,6,2,5,13,2012,GBR
15,UKR,5,4,10,19,2012,GBR
16,CUB,5,3,7,15,2012,GBR
17,ESP,4,10,6,20,2012,GBR
18,JAM,4,5,4,13,2012,GBR
19,CZE,4,4,3,11,2012,GBR
20,RSA,4,1,1,6,2012,GBR
21,PRK,4,0,2,6,2012,GBR
22,BRA,3,5,9,17,2012,GBR
23,KAZ,3,2,6,11,2012,GBR
23,POL,3,2,6,11,2012,GBR
25,ETH,3,2,3,8,2012,GBR
26,CRO,3,1,2,6,2012,GBR
27,CAN,2,6,10,18,2012,GBR
28,BLR,2,5,3,10,2012,GBR
29,KEN,2,4,7,13,2012,GBR
30,DEN,2,4,3,9,2012,GBR
31,ROU,2,4,1,7,2012,GBR
32,AZE,2,2,5,9,2012,GBR
33,SUI,2,2,0,4,2012,GBR
34,NOR,2,1,1,4,2012,GBR
35,LTU,2,0,3,5,2012,GBR
36,TUN,2,0,1,3,2012,GBR
37,SWE,1,4,3,8,2012,GBR
38,COL,1,3,5,9,2012,GBR
39,MEX,1,3,4,8,2012,GBR
40,GEO,1,2,3,6,2012,GBR
41,IRL,1,1,4,6,2012,GBR
42,ARG,1,1,2,4,2012,GBR
42,SRB,1,1,2,4,2012,GBR
42,SLO,1,1,2,4,2012,GBR
42,TTO,1,1,2,4,2012,GBR
46,TUR,1,1,1,3,2012,GBR
47,DOM,1,1,0,2,2012,GBR
48,TPE,1,0,1,2,2012,GBR
48,LAT,1,0,1,2,2012,GBR
50,ALG,1,0,0,1,2012,GBR
50,BAH,1,0,0,1,2012,GBR
50,BRN,1,0,0,1,2012,GBR
50,GRN,1,0,0,1,2012,GBR
50,UGA,1,0,0,1,2012,GBR
50,VEN,1,0,0,1,2012,GBR
56,EGY,0,3,1,4,2012,GBR
57,IND,0,2,4,6,2012,GBR
58,MGL,0,2,3,5,2012,GBR
59,THA,0,2,2,4,2012,GBR
60,BUL,0,2,1,3,2012,GBR
60,FIN,0,2,1,3,2012,GBR
60,INA,0,2,1,3,2012,GBR
63,SVK,0,1,3,4,2012,GBR
64,BEL,0,1,2,3,2012,GBR
65,ARM,0,1,1,2,2012,GBR
65,EST,0,1,1,2,2012,GBR
65,MAS,0,1,1,2,2012,GBR
65,PUR,0,1,1,2,2012,GBR
65,QAT,0,1,1,2,2012,GBR
70,BOT,0,1,0,1,2012,GBR
70,CYP,0,1,0,1,2012,GBR
70,GAB,0,1,0,1,2012,GBR
70,GUA,0,1,0,1,2012,GBR
70,MNE,0,1,0,1,2012,GBR
70,POR,0,1,0,1,2012,GBR
76,UZB,0,0,3,3,2012,GBR
77,GRE,0,0,2,2,2012,GBR
77,SGP,0,0,2,2,2012,GBR
79,AFG,0,0,1,1,2012,GBR
79,CMR,0,0,1,1,2012,GBR
79,HKG,0,0,1,1,2012,GBR
79,KUW,0,0,1,1,2012,GBR
79,MAR,0,0,1,1,2012,GBR
79,KSA,0,0,1,1,2012,GBR
79,TJK,0,0,1,1,2012,GBR
79,VIE,0,0,1,1,2012,GBR
1,USA,46,37,38,121,2016,BRA
2,GBR,27,23,17,67,2016,BRA
3,CHN,26,18,26,70,2016,BRA
4,RUS,19,17,20,56,2016,BRA
5,GER,17,10,15,42,2016,BRA
6,JPN,12,8,21,41,2016,BRA
7,FRA,10,18,14,42,2016,BRA
8,KOR,9,3,9,21,2016,BRA
9,ITA,8,12,8,28,2016,BRA
10,AUS,8,11,10,29,2016,BRA
11,NED,8,7,4,19,2016,BRA
12,HUN,8,3,4,15,2016,BRA
13,BRA,7,6,6,19,2016,BRA
14,ESP,7,4,6,17,2016,BRA
15,KEN,6,6,1,13,2016,BRA
16,JAM,6,3,2,11,2016,BRA
17,CRO,5,3,2,10,2016,BRA
18,CUB,5,2,4,11,2016,BRA
19,NZL,4,9,5,18,2016,BRA
20,CAN,4,3,15,22,2016,BRA
21,UZB,4,2,7,13,2016,BRA
22,COL,3,2,3,8,2016,BRA
23,SUI,3,2,2,7,2016,BRA
24,IRI,3,1,4,8,2016,BRA
25,GRE,3,1,2,6,2016,BRA
26,ARG,3,1,0,4,2016,BRA
27,DEN,2,6,7,15,2016,BRA
28,SWE,2,6,3,11,2016,BRA
29,RSA,2,6,2,10,2016,BRA
30,KAZ,2,5,10,17,2016,BRA
31,UKR,2,5,4,11,2016,BRA
32,SRB,2,4,2,8,2016,BRA
33,POL,2,3,6,11,2016,BRA
34,PRK,2,3,2,7,2016,BRA
35,BEL,2,2,2,6,2016,BRA
35,THA,2,2,2,6,2016,BRA
37,SVK,2,2,0,4,2016,BRA
38,GEO,2,1,4,7,2016,BRA
39,AZE,1,7,10,18,2016,BRA
40,BLR,1,4,4,9,2016,BRA
41,TUR,1,3,4,8,2016,BRA
42,ARM,1,3,0,4,2016,BRA
43,CZE,1,2,7,10,2016,BRA
44,ETH,1,2,5,8,2016,BRA
45,SLO,1,2,1,4,2016,BRA
46,INA,1,2,0,3,2016,BRA
47,ROU,1,1,2,4,2016,BRA
48,BRN,1,1,0,2,2016,BRA
48,VIE,1,1,0,2,2016,BRA
50,TPE,1,0,2,3,2016,BRA
51,BAH,1,0,1,2,2016,BRA
51,Independent Olympic Athletes,1,0,1,2,2016,BRA
51,CIV,1,0,1,2,2016,BRA
54,FIJ,1,0,0,1,2016,BRA
54,JOR,1,0,0,1,2016,BRA
54,KOS,1,0,0,1,2016,BRA
54,PUR,1,0,0,1,2016,BRA
54,SGP,1,0,0,1,2016,BRA
54,TJK,1,0,0,1,2016,BRA
60,MAS,0,4,1,5,2016,BRA
61,MEX,0,3,2,5,2016,BRA
62,VEN,0,2,1,3,2016,BRA
63,ALG,0,2,0,2,2016,BRA
63,IRL,0,2,0,2,2016,BRA
65,LTU,0,1,3,4,2016,BRA
66,BUL,0,1,2,3,2016,BRA
67,IND,0,1,1,2,2016,BRA
67,MGL,0,1,1,2,2016,BRA
69,BDI,0,1,0,1,2016,BRA
69,GRN,0,1,0,1,2016,BRA
69,NIG,0,1,0,1,2016,BRA
69,PHI,0,1,0,1,2016,BRA
69,QAT,0,1,0,1,2016,BRA
74,NOR,0,0,4,4,2016,BRA
75,EGY,0,0,3,3,2016,BRA
75,TUN,0,0,3,3,2016,BRA
77,ISR,0,0,2,2,2016,BRA
78,AUT,0,0,1,1,2016,BRA
78,DOM,0,0,1,1,2016,BRA
78,EST,0,0,1,1,2016,BRA
78,FIN,0,0,1,1,2016,BRA
78,MAR,0,0,1,1,2016,BRA
78,NGR,0,0,1,1,2016,BRA
78,POR,0,0,1,1,2016,BRA
78,TTO,0,0,1,1,2016,BRA
78,UAE,0,0,1,1,2016,BRA
1,USA,39,41,33,113,2020,
2,CHN,38,32,19,89,2020,
3,JPN,27,14,17,58,2020,
4,GBR,22,20,22,64,2020,
5,ROC,20,28,23,71,2020,
6,AUS,17,7,22,46,2020,
7,NED,10,12,14,36,2020,
8,FRA,10,12,11,33,2020,
9,GER,10,11,16,37,2020,
10,ITA,10,10,20,40,2020,
11,CAN,7,7,10,24,2020,
12,BRA,7,6,8,21,2020,
13,NZL,7,6,7,20,2020,
14,CUB,7,3,5,15,2020,
15,HUN,6,7,7,20,2020,
16,KOR,6,4,10,20,2020,
17,POL,4,5,5,14,2020,
18,CZE,4,4,3,11,2020,
19,KEN,4,4,2,10,2020,
20,NOR,4,2,2,8,2020,
21,JAM,4,1,4,9,2020,
22,ESP,3,8,6,17,2020,
23,SWE,3,6,0,9,2020,
24,SUI,3,4,6,13,2020,
25,DEN,3,4,4,11,2020,
26,CRO,3,3,2,8,2020,
27,IRI,3,2,2,7,2020,
28,SRB,3,1,5,9,2020,
29,BEL,3,1,3,7,2020,
30,BUL,3,1,2,6,2020,
31,SLO,3,1,1,5,2020,
32,UZB,3,0,2,5,2020,
33,GEO,2,5,1,8,2020,
34,TPE,2,4,6,12,2020,
35,TUR,2,2,9,13,2020,
36,GRE,2,1,1,4,2020,
36,UGA,2,1,1,4,2020,
38,ECU,2,1,0,3,2020,
39,IRL,2,0,2,4,2020,
39,ISR,2,0,2,4,2020,
41,QAT,2,0,1,3,2020,
42,BAH,2,0,0,2,2020,
42,KOS,2,0,0,2,2020,
44,UKR,1,6,12,19,2020,
45,BLR,1,3,3,7,2020,
46,ROU,1,3,0,4,2020,
46,VEN,1,3,0,4,2020,
48,IND,1,2,4,7,2020,
49,HKG,1,2,3,6,2020,
50,PHI,1,2,1,4,2020,
50,SVK,1,2,1,4,2020,
52,RSA,1,2,0,3,2020,
53,AUT,1,1,5,7,2020,
54,EGY,1,1,4,6,2020,
55,INA,1,1,3,5,2020,
56,ETH,1,1,2,4,2020,
56,POR,1,1,2,4,2020,
58,TUN,1,1,0,2,2020,
59,EST,1,0,1,2,2020,
59,FIJ,1,0,1,2,2020,
59,LAT,1,0,1,2,2020,
59,THA,1,0,1,2,2020,
63,BER,1,0,0,1,2020,
63,MAR,1,0,0,1,2020,
63,PUR,1,0,0,1,2020,
66,COL,0,4,1,5,2020,
67,AZE,0,3,4,7,2020,
68,DOM,0,3,2,5,2020,
69,ARM,0,2,2,4,2020,
70,KGZ,0,2,1,3,2020,
71,MGL,0,1,3,4,2020,
72,ARG,0,1,2,3,2020,
72,SMR,0,1,2,3,2020,
74,JOR,0,1,1,2,2020,
74,MAS,0,1,1,2,2020,
74,NGR,0,1,1,2,2020,
77,BRN,0,1,0,1,2020,
77,LTU,0,1,0,1,2020,
77,NAM,0,1,0,1,2020,
77,MKD,0,1,0,1,2020,
77,KSA,0,1,0,1,2020,
77,TKM,0,1,0,1,2020,
83,KAZ,0,0,8,8,2020,
84,MEX,0,0,4,4,2020,
85,FIN,0,0,2,2,2020,
86,BOT,0,0,1,1,2020,
86,BUR,0,0,1,1,2020,
86,GHA,0,0,1,1,2020,
86,GRN,0,0,1,1,2020,
86,CIV,0,0,1,1,2020,
86,KUW,0,0,1,1,2020,
86,MDA,0,0,1,1,2020,
86,SYR,0,0,1,1,2020,
1,USA,40,44,42,126,2024,FRA
2,CHN,40,27,24,91,2024,FRA
3,JPN,20,12,13,45,2024,FRA
4,AUS,18,19,16,53,2024,FRA
5,FRA,16,26,22,64,2024,FRA
6,NED,15,7,12,34,2024,FRA
7,GBR,14,22,29,65,2024,FRA
8,KOR,13,9,10,32,2024,FRA
9,ITA,12,13,15,40,2024,FRA
10,GER,12,13,8,33,2024,FRA
11,NZL,10,7,3,20,2024,FRA
12,CAN,9,7,11,27,2024,FRA
13,UZB,8,2,3,13,2024,FRA
14,HUN,6,7,6,19,2024,FRA
15,ESP,5,4,9,18,2024,FRA
16,SWE,4,4,3,11,2024,FRA
17,KEN,4,2,5,11,2024,FRA
18,NOR,4,1,3,8,2024,FRA
19,IRL,4,0,3,7,2024,FRA
20,BRA,3,7,10,20,2024,FRA
21,IRI,3,6,3,12,2024,FRA
22,UKR,3,5,4,12,2024,FRA
23,ROU,3,4,2,9,2024,FRA
24,GEO,3,3,1,7,2024,FRA
25,BEL,3,1,6,10,2024,FRA
26,BUL,3,1,3,7,2024,FRA
27,SRB,3,1,1,5,2024,FRA
28,CZE,3,0,2,5,2024,FRA
29,DEN,2,2,5,9,2024,FRA
30,AZE,2,2,3,7,2024,FRA
30,CRO,2,2,3,7,2024,FRA
32,CUB,2,1,6,9,2024,FRA
33,BRN,2,1,1,4,2024,FRA
34,SLO,2,1,0,3,2024,FRA
35,TPE,2,0,5,7,2024,FRA
36,AUT,2,0,3,5,2024,FRA
37,HKG,2,0,2,4,2024,FRA
37,PHI,2,0,2,4,2024,FRA
39,ALG,2,0,1,3,2024,FRA
39,INA,2,0,1,3,2024,FRA
41,ISR,1,5,1,7,2024,FRA
42,POL,1,4,5,10,2024,FRA
43,KAZ,1,3,3,7,2024,FRA
44,JAM,1,3,2,6,2024,FRA
44,RSA,1,3,2,6,2024,FRA
44,THA,1,3,2,6,2024,FRA
47,ETH,1,3,0,4,2024,FRA
48,SUI,1,2,5,8,2024,FRA
49,ECU,1,2,2,5,2024,FRA
50,POR,1,2,1,4,2024,FRA
51,GRE,1,1,6,8,2024,FRA
52,ARG,1,1,1,3,2024,FRA
52,EGY,1,1,1,3,2024,FRA
52,TUN,1,1,1,3,2024,FRA
55,BOT,1,1,0,2,2024,FRA
55,CHI,1,1,0,2,2024,FRA
55,LCA,1,1,0,2,2024,FRA
55,UGA,1,1,0,2,2024,FRA
59,DOM,1,0,2,3,2024,FRA
60,GUA,1,0,1,2,2024,FRA
60,MAR,1,0,1,2,2024,FRA
62,DMA,1,0,0,1,2024,FRA
62,PAK,1,0,0,1,2024,FRA
64,TUR,0,3,5,8,2024,FRA
65,MEX,0,3,2,5,2024,FRA
66,ARM,0,3,1,4,2024,FRA
66,COL,0,3,1,4,2024,FRA
68,KGZ,0,2,4,6,2024,FRA
68,PRK,0,2,4,6,2024,FRA
70,LTU,0,2,2,4,2024,FRA
71,IND,0,1,5,6,2024,FRA
72,MDA,0,1,3,4,2024,FRA
73,KOS,0,1,1,2,2024,FRA
74,CYP,0,1,0,1,2024,FRA
74,FIJ,0,1,0,1,2024,FRA
74,JOR,0,1,0,1,2024,FRA
74,MGL,0,1,0,1,2024,FRA
74,PAN,0,1,0,1,2024,FRA
79,TJK,0,0,3,3,2024,FRA
80,ALB,0,0,2,2,2024,FRA
80,GRN,0,0,2,2,2024,FRA
80,MAS,0,0,2,2,2024,FRA
80,PUR,0,0,2,2,2024,FRA
84,CPV,0,0,1,1,2024,FRA
84,CIV,0,0,1,1,2024,FRA
84,PER,0,0,1,1,2024,FRA
84,QAT,0,0,1,1,2024,FRA
84,EOR,0,0,1,1,2024,FRA
84,SGP,0,0,1,1,2024,FRA
84,SVK,0,0,1,1,2024,FRA
84,ZAM,0,0,1,1,2024,FRA
